It's the strangest thing. You came to stay at your grandfather's house for a month during summer vacation, and two weeks ago while you were out watering the lawn your grandfather disappeared from inside the house and you haven't seen him since. The house is not large, and there is no back door. He's a fairly fit individual for his age, but there is no real reason to suspect that he went out through a window. You filed a missing persons report with the local police department but they have not managed to come up with anything yet either. While wandering through the house, you managed to find a trap door under the stairs, and upon entering you find yourself in...

The Ultimate Text Adventure
An Interactive Fiction by Erik Ylvisaker
Release 1 / Serial number 180621 / Inform 7 build 6M62 (I6/v6.33 lib 6/12N) SD

Under the stairs
You are in the secret room beneath the stairs in your grandfather's house. Shelves line the walls here, with a lot of junk on them. Your grandfather was an avid collector of antiques, but you can tell from the vast array of broken clocks and watches, scratched dishes, tarnished silverware and other junk before you that he doesn't have quite the eye for valuable antiques. There is so much junk that it would take a thorough search to find anything useful. One item does catch your eye, however, the full-length, oval-shaped mirror with a beautiful stand in the corner.

You can type HELP anytime to get help.

>enter mirror
You step through the mirror, and you feel a powerful force pulling you through. After being momentarily blinded, you find yourself in... 

Basement
You appear to be in some sort of Basement, lit solely by a lantern on a shelf. Shelves line the east and north walls, but they are mostly empty. A beautiful mirror stands against the south wall. A ladder pokes through the ceiling in the corner of the room.

On the shelves are journal page 2 and a brass lantern.

>take lantern
Taken.

>u
Inside the Shack
You are inside a dilapidated shack. There is a rather shabby door on the south side, which is closed. This appears to be someone's actual living quarters, as the furnishings are rather complete. It's only one room but there is a kitchen space for cooking as well as a creaky bed. A desk is in the corner, covered in stacks of paper. A ladder pokes through a hole in the floor.

On the kitchen counter is a piece of beef jerky.

>take jerky
Taken.

>s
(first opening the door of the shack)

West Field
You are in the west end of a large, grassy field, surrounded by tall trees. Nestled against the trees at the north end, you see a dilapidated shack. A narrow path goes southwest into the trees. 

You can see a small brown dog here.

The small brown dog destroys the stick.

>examine dog
You can't see any such thing.

>wait
Time passes.

acting intelligently

>wait
Time passes.

acting intelligently

>actions
Actions listing on.

>z
[waiting]
Time passes.
[waiting - succeeded]

[the small brown dog acting intelligently]
acting intelligently
[the small brown dog acting intelligently - succeeded]

>look
[looking]
West Field
You are in the west end of a large, grassy field, surrounded by tall trees. Nestled against the trees at the north end, you see a dilapidated shack. A narrow path goes southwest into the trees. Large raindrops fall from the sky.

You can see a stick here.

[looking - succeeded]

[the small brown dog acting intelligently]
acting intelligently
[the small brown dog acting intelligently - succeeded]

>look dog
You can't see any such thing.

>look
[looking]
West Field
You are in the west end of a large, grassy field, surrounded by tall trees. Nestled against the trees at the north end, you see a dilapidated shack. A narrow path goes southwest into the trees. A fine, misty rain covers everything.

You can see a stick here.

[looking - succeeded]

[the small brown dog acting intelligently]
acting intelligently
[(1) the small brown dog entering the creaky bed]
[(1) the small brown dog entering the creaky bed - succeeded]

[the small brown dog acting intelligently - succeeded]

* * *

>s
(first opening the door of the shack)

West Field
You are in the west end of a large, grassy field, surrounded by tall trees. Nestled against the trees at the north end, you see a dilapidated shack. A narrow path goes southwest into the trees. 

You can see a small brown dog here.

The small brown dog destroys the stick.

>w
The trees are too thick to proceed in that direction.

>sw
Narrow Forest Path
You are in the midst of a dense forest, on a narrow path. The path heads off toward a field in the northeast, and to the west heads deeper into the woods.  A heavy downpour is soaking everything.

>w
Path by Stream
The forest path continues west-east. There is a stream just north of the path with water flowing to the west. It looks as though you could hike down to the stream here. The trees seem to be thinning out to the west. A heavy downpour is soaking everything.

>w
Beach (north end)
You are at the north end of a nice beach. To the west, a vast ocean stretches out before you. The stream from the forest empties into the ocean just north of you. The beach extends to the south. Large raindrops fall from the sky.

>s
Beach S
You are at the south end of a nice beach. A vast ocean stretches out to the west. A rather strange body is here. A rather fine rain is falling.

>examine body
Yes, closer examination reveals that it is actually the body of a mermaid. The smell is an odd mixture of rotting human flesh and fish remains.

You notice she is wearing a bracelet.

>take bracelet
Taken.

>i
You are carrying:
  a power bracelet
  a wand of weather-changing

>wear bracelet
You put on the power bracelet. You feel a surge of magical energy flow through your body! It's as though you could lift anything!

>n
Beach (north end)
You are at the north end of a nice beach. To the west, a vast ocean stretches out before you. The stream from the forest empties into the ocean just north of you. The beach extends to the south. The rain is coming down very heavily.

>e
Path by Stream
The forest path continues west-east. There is a stream just north of the path with water flowing to the west. The trees seem to be thinning out to the west. A heavy downpour is soaking everything.

>e
Narrow Forest Path
You are in the midst of a dense forest, on a narrow path. The path heads off toward a field in the northeast, and to the west heads deeper into the woods.  A rather fine rain is falling.

>e
The trees are too thick to proceed in that direction.

>ne
West Field
You are in the west end of a large, grassy field, surrounded by tall trees. Nestled against the trees at the north end, you see a dilapidated shack. A narrow path goes southwest into the trees. There is a mild drizzle.

You can see a stick here.

>e
East Field
You are at the east end of a large, grassy field. Far to the west in the distance you see a small shack. A narrow path cuts through the trees to the northeast. A rather fine rain is falling.

The remains of a large cow have been rotting here for quite a while, so that only a skeleton is left.

>ne
Forest Clearing
You are in a small clearing deep in the woods. In the center of the clearing is a mausoleum. A narrow path cuts through the trees to the southwest.  Large raindrops fall from the sky.

>enter
You must supply a noun.

>enter mausoleum
Mausoleum Entry
You are in the entryway of a mausoleum. To the west you see a stairway leading up into daylight. East goes deeper into the crypt.

>e
Darkness
It is pitch dark, and you can't see a thing.

>w
Mausoleum Entry
You are in the entryway of a mausoleum. To the west you see a stairway leading up into daylight. East goes deeper into the crypt.

>w
You can't go that way.

>sw
You can't go that way.

>ui
That's not a verb I recognise.

>u
You can't go that way.

>look
Mausoleum Entry
You are in the entryway of a mausoleum. To the west you see a stairway leading up into daylight. East goes deeper into the crypt.

>u
You can't go that way.

>exit
Forest Clearing
You are in a small clearing deep in the woods. In the center of the clearing is a mausoleum. A narrow path cuts through the trees to the southwest.  The rain is coming down very heavily.

>w
The trees are too thick to proceed in that direction.

>sw
East Field
You are at the east end of a large, grassy field. Far to the west in the distance you see a small shack. A narrow path cuts through the trees to the northeast. The rain is coming down very heavily.

The remains of a large cow have been rotting here for quite a while, so that only a skeleton is left.

>w
West Field
You are in the west end of a large, grassy field, surrounded by tall trees. Nestled against the trees at the north end, you see a dilapidated shack. A narrow path goes southwest into the trees. The rain is coming down very heavily.

You can see a stick here.

>n
The trees are too thick to proceed in that direction.

>in
Inside the Shack
You are inside a dilapidated shack. There is a rather shabby door on the south side, which is open. This appears to be someone's actual living quarters, as the furnishings are rather complete. It's only one room but there is a kitchen space for cooking as well as a creaky bed. Above the kitchen counter is a cupboard, which is closed. A desk is in the corner, covered in stacks of paper. A ladder pokes through a hole in the floor.

On the creaky bed is a small brown dog.

On the kitchen counter is a piece of beef jerky.

>d
Basement
You are in the basement of the shack. Shelves line the east and north walls, but they are mostly empty. A beautiful mirror stands against the south wall. A ladder pokes through the ceiling in the corner of the room.

On the shelves are a brass lantern and a ceramic jar (empty).

>take lantern
Taken.

>u
Inside the Shack
You are inside a dilapidated shack. There is a rather shabby door on the south side, which is open. This appears to be someone's actual living quarters, as the furnishings are rather complete. It's only one room but there is a kitchen space for cooking as well as a creaky bed. Above the kitchen counter is a cupboard, which is closed. A desk is in the corner, covered in stacks of paper. A ladder pokes through a hole in the floor.

On the creaky bed is a small brown dog.

On the kitchen counter is a piece of beef jerky.

>s
West Field
You are in the west end of a large, grassy field, surrounded by tall trees. Nestled against the trees at the north end, you see a dilapidated shack. A narrow path goes southwest into the trees. The rain is coming down very heavily.

You can see a stick here.

>e
East Field
You are at the east end of a large, grassy field. Far to the west in the distance you see a small shack. A narrow path cuts through the trees to the northeast. A heavy downpour is soaking everything.

The remains of a large cow have been rotting here for quite a while, so that only a skeleton is left.

>ne
Forest Clearing
You are in a small clearing deep in the woods. In the center of the clearing is a mausoleum. A narrow path cuts through the trees to the southwest.  The rain is coming down very heavily.

>e
The trees are too thick to proceed in that direction.

>in
Mausoleum Entry
You are in the entryway of a mausoleum. To the west you see a stairway leading up into daylight. East goes deeper into the crypt.

>e
Darkness
It is pitch dark, and you can't see a thing.

>turn on lantern
You switch the brass lantern on.

Crypt
This room is definitely a crypt. There is a large stone sarcophagus in the center. Given the intricate designs carved into the sarcophagus and the walls, you suppose someone rich or important was buried here.  Passageways head off to the east, west, north and south.

>open sarcophagus
Thanks to your supernatural strength you are able to push the stone lid off the sarcophagus without any trouble. The force of the lid hitting the ground causes it to crack.

Inside the sarcophagus you see a royal skeleton and a jeweled crown.

>take crown
Taken.

>wear crown
You put on the jeweled crown.

>take royal skeleton
That's fixed in place.

>look
Crypt
This room is definitely a crypt. There is a large stone sarcophagus in the center. Given the intricate designs carved into the sarcophagus and the walls, you suppose someone rich or important was buried here. The stone lid of the sarcophagus apparently has been tossed aside by someone or something of great strength, and lies shattered on the floor. Passageways head off to the east, west, north and south.

>examine sarcophagus
The sarcophagus is shaped like a coffin, just the right size for holding a large man. It's covered beautiful carvings and designs, the likes of which you've never before. 

In the large stone sarcophagus is a royal skeleton.

>take skeleton
That's fixed in place.

>examine crown
It's a beautiful gold crown, encrusted with a variety of valuable gemstones. You feel very wealthy just holding it.

>w
Mausoleum Entry
You are in the entryway of a mausoleum. To the west you see a stairway leading up into daylight. East goes deeper into the crypt.

>e
Crypt
This room is definitely a crypt. There is a large stone sarcophagus in the center. Given the intricate designs carved into the sarcophagus and the walls, you suppose someone rich or important was buried here. The stone lid of the sarcophagus apparently has been tossed aside by someone or something of great strength, and lies shattered on the floor. Passageways head off to the east, west, north and south.

>s
Pit Room (north side)
You are in a room with a deep gaping pit. The pit is rectangular in shape, running east-west and cuts the room in two. To the south across the pit is the other half of the room, and to the north is the passage back to the crypt.

>s
You leap over the pit...

As you leap over the pit, a black wind blows up from the depths, knocking you back to the north.

>s
You leap over the pit...

As you leap over the pit, a black wind blows up from the depths, knocking you back to the north.

>s
You leap over the pit...

As you leap over the pit, a black wind blows up from the depths, knocking you back to the north.

A spooky voice whispers, "turn back, mortal creature." You feel chilled.

>s
You leap over the pit...

As you leap over the pit, a black wind blows up from the depths, knocking you back to the north.

>w
You can't go that way.

>n
Crypt
This room is definitely a crypt. There is a large stone sarcophagus in the center. Given the intricate designs carved into the sarcophagus and the walls, you suppose someone rich or important was buried here. The stone lid of the sarcophagus apparently has been tossed aside by someone or something of great strength, and lies shattered on the floor. Passageways head off to the east, west, north and south.

>w
Mausoleum Entry
You are in the entryway of a mausoleum. To the west you see a stairway leading up into daylight. East goes deeper into the crypt.

* * *

>sw
You can't go that way.

>exit
Forest Clearing
You are in a small clearing deep in the woods. In the center of the clearing is a mausoleum. A narrow path cuts through the trees to the southwest.  There is a mild drizzle.

>sw
East Field
You are at the east end of a large, grassy field. Far to the west in the distance you see a small shack. A narrow path cuts through the trees to the northeast. A fine, misty rain covers everything.

The remains of a large cow have been rotting here for quite a while, so that only a skeleton is left.

>w
West Field
You are in the west end of a large, grassy field, surrounded by tall trees. Nestled against the trees at the north end, you see a dilapidated shack. A narrow path goes southwest into the trees. A fine, misty rain covers everything.

You can see a stick here.

>w
The trees are too thick to proceed in that direction.

>sw
Narrow Forest Path
You are in the midst of a dense forest, on a narrow path. The path heads off toward a field in the northeast, and to the west heads deeper into the woods.  There is a mild drizzle.

>w
Path by Stream
The forest path continues west-east. There is a stream just north of the path with water flowing to the west. The trees seem to be thinning out to the west. A rather fine rain is falling.

>n
South Stream Bank
You are at the southern bank of the stream. The water flows steadily to the west. The trees of the forest surround you, and you see the forest continues on the north side of the stream. Large raindrops fall from the sky.

>n
You wade through the stream...

North Stream Bank
This is the northern bank of the stream. You stand atop a small muddy beach. A dreary rain covers the area.

>e
Waterfall
You stand before a fantastic waterfall. The noise of the waterfall is deafening, drowning out even the sound of the rain. Large raindrops fall from the sky.

>n
The trees are too thick to proceed in that direction.

>in
The trees are too thick to proceed in that direction.

>enter waterfall
Taking a deep breath, you plunge right into the waterfall!

Cave Inside Waterfall
You are in a small cave inside the waterfall.

You can see a blue crystal sphere here.

>take sphere
Taken.

>s
You can't go that way.

>w
You can't go that way.

>s
You can't go that way.

* * *

>s
(first opening the door of the shack)

West Field
You are in the west end of a large, grassy field, surrounded by tall trees. Nestled against the trees at the north end, you see a dilapidated shack. A narrow path goes southwest into the trees. 

You can see a small brown dog here.

The small brown dog destroys the stick.

>give jerky to dog
You give the piece of beef jerky to the small brown dog.

>give jerky to dog
The small brown dog does not respond.

>give jerky to dog
The small brown dog stares intently at you, waiting for you to give her the piece of beef jerky.

>look
West Field
You are in the west end of a large, grassy field, surrounded by tall trees. Nestled against the trees at the north end, you see a dilapidated shack. A narrow path goes southwest into the trees. 

You can see a small brown dog here.

The small brown dog stares intently at you, waiting for you to give her the piece of beef jerky.

>give jerky to dog
The small brown dog apparently gives up on getting the piece of beef jerky.

>rules
Rules tracing now switched on. Type "rules off" to switch it off again, or "rules all" to include even rules which do not apply.

>give jerky to dog
[Rule "note giving rule" applies.]
[Rule "Check giving something to a canine ( called the dog )" applies.]
[Rule "can't give what you haven't got rule" applies.]
[Rule "can't give to yourself rule" applies.]
[Rule "can't give to a non-person rule" applies.]
[Rule "can't give clothes being worn rule" applies.]
[Rule "polite refusal of unwanted objects rule" applies.]
[Rule "Rule for updating state of a canine ( called the dog )" applies.]
[Rule "Carry out a canine ( called the dog ) acting intelligently" applies.]
[Rule "After someone doing something when the person asked is a canine" applies.]

* * *

>give jerky to dog
You give the piece of beef jerky to the small brown dog.

>z
Time passes.

The small brown dog apparently gives up on getting the piece of beef jerky.

>give jerky to dog
The small brown dog does not respond.

>rules
Rules tracing now switched on. Type "rules off" to switch it off again, or "rules all" to include even rules which do not apply.

>give jerky to dog
[Rule "note giving rule" applies.]
[Rule "dogs can't carry bulky things rule" applies.]
[Rule "dogs can't carry more than one thing rule" applies.]
[Rule "can't give what you haven't got rule" applies.]
[Rule "can't give to yourself rule" applies.]
[Rule "can't give to a non-person rule" applies.]
[Rule "can't give clothes being worn rule" applies.]
[Rule "polite refusal of unwanted objects rule" applies.]
[Rule "After giving something edible to a canine ( called the dog )" applies.]
[Rule "After giving something to a canine ( called the dog )" applies.]
[Rule "open node response rule" applies.]
[Rule "standard response rule" applies.]
[Rule "default giving rule" applies.]
[Rule "try default give-show response rule" applies.]
[Rule "try default response rule" applies.]
The small brown dog does not respond.

[Rule "Rule for updating state of a canine ( called the dog )" applies.]
[Rule "Carry out a canine ( called the dog ) acting intelligently" applies.]
[Rule "After someone doing something when the person asked is a canine" applies.]

* * *

>take jerky
Taken.

>search desk
As you search through the papers on the desk you manage to knock a large stack of papers onto the floor, including a couple of pages from a journal that look interesting.

You hear scratches at the shabby door.

>look
Inside the Shack
You are inside a dilapidated shack. There is a rather shabby door on the south side, which is closed. This appears to be someone's actual living quarters, as the furnishings are rather complete. It's only one room but there is a kitchen space for cooking as well as a creaky bed. A desk is in the corner, covered in stacks of paper. A ladder pokes through a hole in the floor.

On the floor is the mess of papers you knocked off the desk.

On the kitchen counter is a piece of beef jerky.

On the desk is journal page 5.

You can also see journal page 4 and journal page 3 here.

You hear barking coming from beyond the shabby door.

>take page on desk
[Which do you mean, 1) journal page 4, 2) journal page 3 or 3) journal page 5?]

>take page 5
Taken.

You hear scratches at the shabby door.

>look
Inside the Shack
You are inside a dilapidated shack. There is a rather shabby door on the south side, which is closed. This appears to be someone's actual living quarters, as the furnishings are rather complete. It's only one room but there is a kitchen space for cooking as well as a creaky bed. A desk is in the corner, covered in stacks of paper. A ladder pokes through a hole in the floor.

On the floor is the mess of papers you knocked off the desk.

On the kitchen counter is a piece of beef jerky.

You can also see journal page 4 and journal page 3 here.

You hear barking coming from beyond the shabby door.

>put page 5 on desk
You put journal page 5 on the desk.

You hear scratches at the shabby door.

>take the journal page on the desk
[Which do you mean, 1) journal page 4, 2) journal page 3 or 3) journal page 5?]

>the one on the desk
[You typed a rather long command and I didn't understand it. It's better to stick to simpler things like TAKE JOURNAL PAGE 3.]

>take the journal page on the desk
[Which do you mean, 1) journal page 4, 2) journal page 3 or 3) journal page 5?]

>the one on the desk
[You typed a rather long command and I didn't understand it. It's better to stick to simpler things like TAKE JOURNAL PAGE 5.]

>read all pages
[You can't use multiple objects with that verb.]

>read journal page 5
(First taking journal page 5.)

The text reads:

June 2nd I have managed to train Atari in a few things. I have to say her name each time I want to give her a command. Saying something like "Atari, get on the bed" seems to work well. She only seems to be obedient when I am holding some food however.

You hear barking coming from beyond the shabby door.

>open door
You open the shabby door.

Atari arrives from the outside.

>read journal page 4
(First taking journal page 4.)

This page has been ripped and heavily chewed on. Only a few words are legible:

May 26th That damn dog! It seems ... to chew on my ... to rip out several pages ... severe damage the bind... more careful about...

The rest of the page is missing.

Atari greets you happily with her tail wagging vigorously, apparently very excited to see you.

>look
Inside the Shack
You are inside a dilapidated shack. There is a rather shabby door on the south side, which is open. This appears to be someone's actual living quarters, as the furnishings are rather complete. It's only one room but there is a kitchen space for cooking as well as a creaky bed. A desk is in the corner, covered in stacks of paper. A ladder pokes through a hole in the floor.

On the floor is the mess of papers you knocked off the desk.

On the kitchen counter is a piece of beef jerky.

You can also see Atari and journal page 3 here.

Atari greets you happily with her tail wagging vigorously, apparently very excited to see you.

>sit on bed
You get onto the creaky bed.

Atari is so excited to see you, she jumps right into your arms.

>drop atari
Dropped.

Atari gets off the creaky bed.

>z
Time passes.

[** Programming error: tried to find the "parent" of nothing **]

>z
Time passes.

[** Programming error: tried to find the "parent" of nothing **]

* * *

>enter mirror
You step through the mirror, and you feel a powerful force pulling you through. After being momentarily blinded, you find yourself in... 

Basement
You appear to be in some sort of Basement, lit solely by a lantern on a shelf. Shelves line the east and north walls, but they are mostly empty. A beautiful mirror stands against the south wall. A ladder pokes through the ceiling in the corner of the room.

On the shelves are journal page 2 and a brass lantern.

>take all
journal page 2: Taken.

brass lantern: Taken.

I beg your pardon?

>u
Inside the Shack
You are inside a dilapidated shack. There is a rather shabby door on the south side, which is closed. This appears to be someone's actual living quarters, as the furnishings are rather complete. It's only one room but there is a kitchen space for cooking as well as a creaky bed. A desk is in the corner, covered in stacks of paper. A ladder pokes through a hole in the floor.

On the kitchen counter is a piece of beef jerky.

>sit on bed
You get onto the creaky bed.

>get up
You get off the creaky bed.

Inside the Shack
You are inside a dilapidated shack. There is a rather shabby door on the south side, which is closed. This appears to be someone's actual living quarters, as the furnishings are rather complete. It's only one room but there is a kitchen space for cooking as well as a creaky bed. A desk is in the corner, covered in stacks of paper. A ladder pokes through a hole in the floor.

On the kitchen counter is a piece of beef jerky.

>sit
You sit down.

>take jerky
Taken.

>s
(first opening the door of the shack)

West Field
You are in the west end of a large, grassy field, surrounded by tall trees. Nestled against the trees at the north end, you see a dilapidated shack. A narrow path goes southwest into the trees. 

You can see a small brown dog here.

The small brown dog is so excited to see you, she jumps right into your arms.

>look dog
She's a little brown dog, with some white markings on her feet and neck that gives the appearance that she's wearing socks and a handkerchief. She is wearing a black collar. She is very excited.

The small brown dog snuggles in your arms.

>drop dog
Dropped.

The small brown dog is so excited to see you, she jumps right into your arms.

>drop dog
Dropped.

The small brown dog apparently gives up on getting the piece of beef jerky.

>give jerky to dog
You give the piece of beef jerky to the small brown dog.

>s
The trees are too thick to proceed in that direction.

The small brown dog eats the piece of beef jerky.

>w
Stream Bend
You are on a rocky bank of the stream, which flows from the northeast to the west. In the northeast, you see that the stream flows from a magnificent waterfall. The rock formations in the water redirect the fast flow of the stream into several small pools, where the water stagnates and reeds grow out of it like there's no tomorrow. You detect the faint smell of decaying matter here. 

The small brown dog arrives from the east.

>s
The trees are too thick to proceed in that direction.

>w
South Stream Bank
You are at the southern bank of the stream. The water flows steadily to the west, and it looks fairly shallow at this point. The trees of the forest surround you, and you see the forest continues on the north side of the stream. There appears to be a shallow sand bar in the stream to the north; you might be able to wade across to it. You see there is enough of a bank for you to travel to the east or southwest along the stream edge. 

The small brown dog arrives from the east.

>n
The trees are too thick to proceed in that direction.

The small brown dog playfully nips at your heels.

>w
The trees are too thick to proceed in that direction.

The small brown dog growls playfully.

>look forest
These are large pine trees, or some variety of coniferous species. It's hard to really tell, since you are not exactly an arborist.

The small brown dog playfully nips at your heels.

>kick dog
That's not a verb I recognise.

>hit dog
Violence isn't the answer to this one.

The small brown dog growls playfully.

>e
You walk carefully along the edge of the stream.

Stream Bend
You are on a rocky bank of the stream, which flows from the northeast to the west. In the northeast, you see that the stream flows from a magnificent waterfall. The rock formations in the water redirect the fast flow of the stream into several small pools, where the water stagnates and reeds grow out of it like there's no tomorrow. You detect the faint smell of decaying matter here. 

The small brown dog arrives from the west.

>n
The trees are too thick to proceed in that direction.

The small brown dog playfully nips at your heels.

>attack dog
Violence isn't the answer to this one.

>e
West Field
You are in the west end of a large, grassy field, surrounded by tall trees. Nestled against the trees at the north end, you see a dilapidated shack. A narrow path goes southwest into the trees. 

The small brown dog arrives from the west.

>e
East Field
You are at the east end of a large, grassy field. Far to the west in the distance you see a small shack. A narrow path cuts through the trees to the northeast. To the south, another path goes into the forest. 

The remains of a large cow have been rotting here for quite a while, so that only a skeleton is left.

The small brown dog arrives from the west.

>e
The trees are too thick to proceed in that direction.

The small brown dog gnaws on the bovine skeleton.
The small brown dog manages to pull off a bovine bone!

>s
Creepy Forest Path
You are on a north-south path through the woods. The trees in this area are twisted and creepy, and the canopy blocks all but a few slivers of light from above. 

The small brown dog arrives from the north.

>s
Outside the Tower
You stand at the base of a large stone tower. The woods surround you in all directions, except for the lone path going to the north. 

The small brown dog arrives from the north.

>s
The trees are too thick to proceed in that direction.

The small brown dog gnaws at the bovine bone.

>enter tower
(first opening the tower door)

Tower Den
You are inside a lavish den, furnished with immaculate furniture and rugs. A fire burns in a fireplace on the west wall. There is a wonderful smell in the room, like a mixture of the aromas of hazelnuts and almonds.

A small, aged man with a long beard sits in a brown recliner, smoking a pipe. He was reading a book when you barged into his home, but despite your rudeness, he looks up with a smile on his face. Something about him gives you a warm, friendly feeling.

>say hello
(addressing the wizard)
"Hi, um.. apologies for barging into your home," you mumble, a bit embarrassed that you have just committed your first breaking and entering offense. 

"No worries," says the wizard. "It's rare that I get company all the way out here, please make yourself at home." The wizard's friendliness makes you feel as though you were invited in to begin with.

You have nothing specific in mind to discuss with wizard just now.

>ask about grandfather
"I'm looking for my grandfather," you mention. "I think he may have disappeared from around here a couple of weeks ago." 

"Ah, that is unfortunate," says the wizard. "Allow me to think for a moment." The wizard pauses, taking a few long puffs from his pipe. 

"You know, I recall hearing a rumor about some elderly person that was arrested from the field north of here. I can't remember what the charge was but he was probably thrown in the castle dungeon by that tyrant of a king."

>ask about chocolate
The wizard responds, "I'm not really sure about that."

>n
You can't go that way.

>s
You can't go that way.

>exit
Outside the Tower
You stand at the base of a large stone tower. The woods surround you in all directions, except for the lone path going to the north. 

You can see a small brown dog here.

The small brown dog licks the surface of the bovine bone.

>enter
You must supply a noun.

The small brown dog drops the bovine bone.

>enter tower
Tower Den
You are inside a lavish den, furnished with immaculate furniture and rugs. A fire burns in a fireplace on the west wall. There is a wonderful smell in the room, like a mixture of the aromas of hazelnuts and almonds.

A small, aged man with a long beard sits in a brown recliner, smoking a pipe. He was reading a book when you barged into his home, but despite your rudeness, he looks up with a smile on his face. Something about him gives you a warm, friendly feeling.

>say hello
(addressing the wizard)
"Hello," you greet the wizard. 

"Hello again," he responds."

(You could ask him about Grandfather, the small brown dog or the tyrant king.)

>ask about dog
The wizard responds, "I'm not really sure about that."

>ask about atari
"Have you seen the small brown dog around?" you ask. 

"Yes, I've seen that little brown dog running around." he replies. "Yes, yes, she seems very friendly."

>ask about king
"So what's the deal with the king?" you ask. 

"Ach, that fool of a ruler," the wizard spits out, his expression darkening for the first time. "He rules with impunity, overtaxing his people simply to line his own coffers. It was a dark day when he came into power." The wizard looks at you, a glint in his eye. "I'd stay out of his way, if I were you, lest you meet your grandfather's fate."

>ask about grandfather
"I'm looking for my grandfather," you begin, but the wizard quickly interrupts you. 

"Yes, yes, I know, you said that already. Now where were we? Weren't we talking about the king? Or was it fate?"

>ask about fate
"What do you mean, my grandfather's fate?" you ask, nervous about what that might mean. 

"Oh sorry, I didn't mean to alarm you," the wizard responds. "I'm sure he's alive and well. The king has his faults, but he is not quick to execute interlopers." The wizard pauses, and stares at you thoughtfully. "You know," he begins, "I might be able to help you to rescue your grandfather. The king was once a student of mine, and in spite of our differences, I still have some sway with him," the wizard pauses, puffing on his pipe. "There are two important national artifacts that have been missing for several years. If you could bring them to me I will speak to the king on your behalf. I'm sure that he would be willing to grant a favor to the person who finds and returns them."

>ask about artifacts
"What artifacts are you looking for?" you ask. 

"There are two of them," the wizard repeats. He pauses thoughtfully, taking one long puff on his pipe. "I am looking for a crown and a scepter. They both belonged to a previous king from a few generations back, a fair and just man by the name of Dalton. His crown and scepter both disappeared when he died. Bring me those items, and I will see that your grandfather is returned to you." The wizard stares at you. You are suddenly awash with the feeling that this is an individual with considerable power.

>ask about crown
"What can you tell me about the crown?" you ask. 

"Ah the crown," the wizard sighs. "It was a wonderfully beautiful object to behold. It's made of solid gold, and encrusted with all manner of rare and valuable jewels, but it is light-weight and slim for a real elegant look. I saw it up close once, you know, when I was but a lad who had barely seen eight summers. Some say it had some sort of magical power. Rumor has it, the crown was buried with the king when he died." The wizard puffs on his pipe again and lets out a sigh. "Unfortunately, in these dark times thievery runs rampant. The mausoleum where he is buried has been thoroughly ransack by brigands, and this wonderful national treasure has long been lost."

>ask about scepter
"What about the scepter?" you ask. 

The wizard pauses for a moment, collecting his thoughts. "Little is really known about the scepter. The former king always carried it with him, but it was rarely prominently displayed. There was some rumor that after his death it fell into the possession of a friend of his, who captained a ship. One day, that ship set sail and never returned. Some say the ship was sunk in a great battle by pirates, others say the ship ran aground on a reef somewhere and the crew ended up starving." 

Another long drag on the pipe, and then the wizard shrugs, "Perhaps they simply found treasure somewhere and have retired to some island paradise. No one even knows if the scepter was on the ship when it disappeared." The wizard stares off into the distance, as if remembering some long-forgotten painful event. "Even with my skill with magical scrying, I have been unable to locate the scepter."

The wizard looks at you pointedly, leaning forward in his chair. "So what do you say? Will you look for the crown and scepter?"

(You could say yes or no; or ask him about the jeweled crown or the scepter.)

>say yes
(to the wizard)
"Yes, if it will help me get my grandfather back, I'll do it," you reply in the affirmative. 

"Excellent!" announces the wizard. "I have a gift for you. I suspect you will need to return to your own home to gather things which may help you find the crown and scepter. Somewhere near the waterfall there is a key for a lost traveler to return home, but that such a key can only be found during a terrible storm. I will give you this wand of weather-changing. It's very easy to use, all you need to do is wave the wand and it will effect a change in the weather. I'd suggest digging in the sand around the banks near the waterfall for that key." 

The wizard holds out his hand offering you the wand, which you take carefully. 

"Be sure and bring the crown and scepter back to me," the wizard continues, "and be careful who you show them to. There are many out there who would think nothing of killing you to obtain these artifacts."

>n
You can't go that way.

>exit
Outside the Tower
You stand at the base of a large stone tower. The woods surround you in all directions, except for the lone path going to the north. 

You can see a small brown dog here.

The small brown dog is so excited to see you, she jumps right into your arms.

>wave wand
It is now clear skies.

The small brown dog snuggles in your arms.

>wave wand
It is now clear skies.

The small brown dog snuggles in your arms.

>n
Creepy Forest Path
You are on a north-south path through the woods. The trees in this area are twisted and creepy, and the canopy blocks all but a few slivers of light from above.

>i
You are carrying:
  a small brown dog
  a wand of weather-changing
  a brass lantern
  journal page 2

The small brown dog wriggles free of your grasp.

>look at dog
She's a little brown dog, with some white markings on her feet and neck that gives the appearance that she's wearing socks and a handkerchief. She is wearing a black collar. She is playful.

The small brown dog growls playfully.

>look at collar
It's a black dog collar. Hanging from the hook on the collar is a small tag which reads "Atari."

Atari playfully nips at your heels.

>w
The trees are too thick to proceed in that direction.

>n
East Field
You are at the east end of a large, grassy field. Far to the west in the distance you see a small shack. A narrow path cuts through the trees to the northeast. To the south, another path goes into the forest. 

The remains of a large cow have been rotting here for quite a while, so that only a skeleton is left.

Atari arrives from the south.

>w
West Field
You are in the west end of a large, grassy field, surrounded by tall trees. Nestled against the trees at the north end, you see a dilapidated shack. A narrow path goes southwest into the trees. 

Atari arrives from the east.

>e
East Field
You are at the east end of a large, grassy field. Far to the west in the distance you see a small shack. A narrow path cuts through the trees to the northeast. To the south, another path goes into the forest. 

The remains of a large cow have been rotting here for quite a while, so that only a skeleton is left.

Atari arrives from the west.

>n
The trees are too thick to proceed in that direction.

Atari tugs at the bovine skeleton.

>n
The trees are too thick to proceed in that direction.

Atari grabs onto the bovine skeleton and begins tugging.

>n
The trees are too thick to proceed in that direction.

Atari tugs at the bovine skeleton.

>z
Time passes.

Atari gnaws on the bovine skeleton.
Atari manages to pull off a bovine bone!

>z
Time passes.

Atari gnaws at the bovine bone.

>look at atari
She's a little brown dog, with some white markings on her feet and neck that gives the appearance that she's wearing socks and a handkerchief. She is wearing a black collar. She is carrying a bovine bone. She is playful.

Atari drops the bovine bone.

>w
West Field
You are in the west end of a large, grassy field, surrounded by tall trees. Nestled against the trees at the north end, you see a dilapidated shack. A narrow path goes southwest into the trees. 

Atari arrives from the east.

>n
The trees are too thick to proceed in that direction.

Atari stretches.

>wave wand
It is now clear skies.

Atari growls playfully.

>w
Stream Bend
You are on a rocky bank of the stream, which flows from the northeast to the west. In the northeast, you see that the stream flows from a magnificent waterfall. The rock formations in the water redirect the fast flow of the stream into several small pools, where the water stagnates and reeds grow out of it like there's no tomorrow. You detect the faint smell of decaying matter here. 

Atari arrives from the east.

>n
The trees are too thick to proceed in that direction.

>w
South Stream Bank
You are at the southern bank of the stream. The water flows steadily to the west, and it looks fairly shallow at this point. The trees of the forest surround you, and you see the forest continues on the north side of the stream. There appears to be a shallow sand bar in the stream to the north; you might be able to wade across to it. You see there is enough of a bank for you to travel to the east or southwest along the stream edge. 

Atari arrives from the east.

>n
The trees are too thick to proceed in that direction.

Atari stretches.

>w
The trees are too thick to proceed in that direction.

Atari playfully nips at your heels.

>n
The trees are too thick to proceed in that direction.

Atari growls playfully.

>s
Path by Stream
The forest path continues west-east. There is a stream just north of the path with water flowing to the west. It looks as though you could hike down to the stream here. The trees seem to be thinning out to the west. 

Atari arrives from the north.

>w
Beach (north end)
You are at the north end of a nice beach. To the west, a vast ocean stretches out before you. The stream from the forest empties into the ocean just north of you. The beach extends to the south. 

Atari arrives from the east.

>s
Beach (south end)
You are at the south end of a nice beach. A vast ocean stretches out to the west. This end of the beach is surrounded by rocks, blocking all passage except to the north. 

It looks as though the body of a mermaid has washed up on shore.

A canoe in rather poor shape is overturned on the beach.

Atari arrives from the north.

>look mermaid
Yes, closer examination reveals that it is actually the body of a mermaid. The smell is an odd mixture of rotting human flesh and decaying fish matter.

You notice she is wearing a bracelet.

Atari playfully nips at your heels.

>take bracelet
As you reach for the power bracelet, Atari leaps in quickly and grabs it first.

>atari, drop it
Atari drops the power bracelet.

>take bracelet
Taken.

Atari growls as she pulls at the mermaid carcass.

>atari, stop
Atari does not respond.

Atari grabs onto the mermaid carcass and begins tugging.

>take atari
Taken.

>s
It's too rocky to proceed in that direction.

Atari wriggles free of your grasp.

>take atari
Taken.

>n
Beach (north end)
You are at the north end of a nice beach. To the west, a vast ocean stretches out before you. The stream from the forest empties into the ocean just north of you. The beach extends to the south. 

Atari wriggles free of your grasp.

>w
You can't exactly swim across the ocean, you know.

Atari stretches.

>n
You could wade across the stream, but the shore on the other side looks to be too covered in vegetation for there to be anywhere for you to go. Maybe there is a place further east where you can wade across the stream.

>e
Path by Stream
The forest path continues west-east. There is a stream just north of the path with water flowing to the west. It looks as though you could hike down to the stream here. The trees seem to be thinning out to the west. 

Atari arrives from the west.

>n
South Stream Bank
You are at the southern bank of the stream. The water flows steadily to the west, and it looks fairly shallow at this point. The trees of the forest surround you, and you see the forest continues on the north side of the stream. There appears to be a shallow sand bar in the stream to the north; you might be able to wade across to it. You see there is enough of a bank for you to travel to the east or southwest along the stream edge. 

Atari arrives from the south.

>n
The trees are too thick to proceed in that direction.

Atari growls playfully.

>w
The trees are too thick to proceed in that direction.

Atari playfully nips at your heels.

* * *

>n
The trees are too thick to proceed in that direction.

Atari growls playfully.

>wade
That's not a verb I recognise.

>cross stream
That's not something you can enter.

Atari playfully nips at your heels.

>sw
Beach (north end)
You are at the north end of a nice beach. To the west, a vast ocean stretches out before you. The stream from the forest empties into the ocean just north of you. The beach extends to the south. 

Atari arrives from the northeast.

>e
Path by Stream
The forest path continues west-east. There is a stream just north of the path with water flowing to the west. It looks as though you could hike down to the stream here. The trees seem to be thinning out to the west. 

Atari arrives from the west.

* * *

>n
South Stream Bank
You are at the southern bank of the stream. The water flows steadily to the west, and it looks fairly shallow at this point. The trees of the forest surround you, and you see the forest continues on the north side of the stream. There appears to be a shallow sand bar in the stream to the north; you might be able to wade across to it. You see there is enough of a bank for you to travel to the east or southwest along the stream edge. 

Atari arrives from the south.

>w
The trees are too thick to proceed in that direction.

Atari growls playfully.

>n
The trees are too thick to proceed in that direction.

>e
You walk carefully along the edge of the stream.

Stream Bend
You are on a rocky bank of the stream, which flows from the northeast to the west. In the northeast, you see that the stream flows from a magnificent waterfall. The rock formations in the water redirect the fast flow of the stream into several small pools, where the water stagnates and reeds grow out of it like there's no tomorrow. You detect the faint smell of decaying matter here. 

Atari arrives from the west.

>n
The trees are too thick to proceed in that direction.

Atari playfully nips at your heels.

>n
The trees are too thick to proceed in that direction.

>e
West Field
You are in the west end of a large, grassy field, surrounded by tall trees. Nestled against the trees at the north end, you see a dilapidated shack. A narrow path goes southwest into the trees. 

Atari arrives from the west.

>e
East Field
You are at the east end of a large, grassy field. Far to the west in the distance you see a small shack. A narrow path cuts through the trees to the northeast. To the south, another path goes into the forest. 

The remains of a large cow have been rotting here for quite a while, so that only a skeleton is left.

You can also see a bovine bone here.

Atari arrives from the west.

>take atari
Taken.

>enter shack
You'll have to get closer first. Try going west.

Atari wriggles free of your grasp.

>w
West Field
You are in the west end of a large, grassy field, surrounded by tall trees. Nestled against the trees at the north end, you see a dilapidated shack. A narrow path goes southwest into the trees. 

Atari arrives from the east.

>enter shack
Inside the Shack
You are inside a dilapidated shack. There is a rather shabby door on the south side, which is open. This appears to be someone's actual living quarters, as the furnishings are rather complete. It's only one room but there is a kitchen space for cooking as well as a creaky bed. A desk is in the corner, covered in stacks of paper. A ladder pokes through a hole in the floor.

Atari arrives from the outside.

>w. close door
You can't go that way.

You close the shabby door.

Atari stretches.

>look
Inside the Shack
You are inside a dilapidated shack. There is a rather shabby door on the south side, which is closed. This appears to be someone's actual living quarters, as the furnishings are rather complete. It's only one room but there is a kitchen space for cooking as well as a creaky bed. A desk is in the corner, covered in stacks of paper. A ladder pokes through a hole in the floor.

You can see Atari here.

Atari stretches.

>s. close door
(first opening the door of the shack)

West Field
You are in the west end of a large, grassy field, surrounded by tall trees. Nestled against the trees at the north end, you see a dilapidated shack. A narrow path goes southwest into the trees. 

Atari arrives from the inside.

You close the shabby door.

Atari growls playfully.

>look
West Field
You are in the west end of a large, grassy field, surrounded by tall trees. Nestled against the trees at the north end, you see a dilapidated shack. A narrow path goes southwest into the trees. 

You can see Atari here.

>n
The trees are too thick to proceed in that direction.

Atari playfully nips at your heels.

>enter shack
(first opening the door of the shack)

Inside the Shack
You are inside a dilapidated shack. There is a rather shabby door on the south side, which is open. This appears to be someone's actual living quarters, as the furnishings are rather complete. It's only one room but there is a kitchen space for cooking as well as a creaky bed. A desk is in the corner, covered in stacks of paper. A ladder pokes through a hole in the floor.

Atari arrives from the outside.

>atari, stay
Atari does not respond.

>stari stop
That's not a verb I recognise.

>atari stop
That's not a verb I recognise.

>atari, stop
Atari does not respond.

Atari growls playfully.

>atari, sit
Atari sits down.

>s
West Field
You are in the west end of a large, grassy field, surrounded by tall trees. Nestled against the trees at the north end, you see a dilapidated shack. A narrow path goes southwest into the trees. 

Atari arrives from the inside.

>n
The trees are too thick to proceed in that direction.

Atari playfully nips at your heels.

>sw
Narrow Forest Path
You are in the midst of a dense forest, on a narrow path. The path heads off toward a field in the northeast, and to the west heads deeper into the woods. You can hear birds chirping in the trees, and the sound of rushing water nearby. 

Atari arrives from the northeast.

>w
Path by Stream
The forest path continues west-east. There is a stream just north of the path with water flowing to the west. It looks as though you could hike down to the stream here. The trees seem to be thinning out to the west. 

Atari arrives from the east.

>w
Beach (north end)
You are at the north end of a nice beach. To the west, a vast ocean stretches out before you. The stream from the forest empties into the ocean just north of you. The beach extends to the south. 

Atari arrives from the east.

>s
Beach (south end)
You are at the south end of a nice beach. A vast ocean stretches out to the west. This end of the beach is surrounded by rocks, blocking all passage except to the north. 

The rotting carcass of a mermaid is washed up on the shore here.

A canoe in rather poor shape is overturned on the beach.

Atari arrives from the north.

>look at canoe
The wood making up the canoe has rotted through in a few places, and it looks as thought there might be termites eating away at some parts of it. It will probably never be sea-worthy again.

Atari growls playfully.

>lift canoe
That's not a verb I recognise.

>move canoe
You manage to flip over the canoe. Underneath you see an oar.

Atari playfully nips at your heels.

>take oar
Taken.

Atari tugs at the mermaid carcass.

>throw oar
The wooden oar is too heavy to throw.

Atari grabs onto the mermaid carcass and begins tugging.

>take oar
The wooden oar is rather bulky, so it's going to be difficult to carry it while you're holding on to the wooden oar.

Atari growls as she pulls at the mermaid carcass.
Atari manages to pull off a mermaid scale!

>take scale
That seems to belong to Atari.

Atari happily chews on the mermaid scale.

>atari, drop it
Atari drops the mermaid scale.

>take scale
As you reach for the mermaid scale, Atari leaps in quickly and grabs it first.

>atari, drop it
Atari drops the mermaid scale.

>take scale
Taken.

>n
Beach (north end)
You are at the north end of a nice beach. To the west, a vast ocean stretches out before you. The stream from the forest empties into the ocean just north of you. The beach extends to the south. 

Atari arrives from the south.

>look scale
You see nothing special about the mermaid scale.

Atari stretches.

>n
You could wade across the stream, but the shore on the other side looks to be too covered in vegetation for there to be anywhere for you to go. Maybe there is a place further east where you can wade across the stream.

Atari growls playfully.

>e
Path by Stream
The forest path continues west-east. There is a stream just north of the path with water flowing to the west. It looks as though you could hike down to the stream here. The trees seem to be thinning out to the west. 

Atari arrives from the west.

>e
Narrow Forest Path
You are in the midst of a dense forest, on a narrow path. The path heads off toward a field in the northeast, and to the west heads deeper into the woods. You can hear birds chirping in the trees, and the sound of rushing water nearby. 

Atari arrives from the west.

>e
The trees are too thick to proceed in that direction.

Atari playfully nips at your heels.

>e
The trees are too thick to proceed in that direction.

Atari stretches.

>e
The trees are too thick to proceed in that direction.

Atari growls playfully.

>e
The trees are too thick to proceed in that direction.

Atari playfully nips at your heels.

I beg your pardon?

>e
The trees are too thick to proceed in that direction.

Atari stretches.

* * *

>e
The trees are too thick to proceed in that direction.

Atari growls playfully.

>e
The trees are too thick to proceed in that direction.

Atari stretches.

>e
The trees are too thick to proceed in that direction.

Atari stretches.

>e
The trees are too thick to proceed in that direction.

Atari playfully nips at your heels.

>e
The trees are too thick to proceed in that direction.

Atari growls playfully.

>s
The trees are too thick to proceed in that direction.

>s
The trees are too thick to proceed in that direction.

Atari playfully nips at your heels.

>s
The trees are too thick to proceed in that direction.

>se
The trees are too thick to proceed in that direction.

Atari growls playfully.

>look
Narrow Forest Path
You are in the midst of a dense forest, on a narrow path. The path heads off toward a field in the northeast, and to the west heads deeper into the woods. You can hear birds chirping in the trees, and the sound of rushing water nearby. 

You can see Atari here.

>ne
West Field
You are in the west end of a large, grassy field, surrounded by tall trees. Nestled against the trees at the north end, you see a dilapidated shack. A narrow path goes southwest into the trees. 

Atari arrives from the southwest.

>n
The trees are too thick to proceed in that direction.

>e
East Field
You are at the east end of a large, grassy field. Far to the west in the distance you see a small shack. A narrow path cuts through the trees to the northeast. To the south, another path goes into the forest. 

The remains of a large cow have been rotting here for quite a while, so that only a skeleton is left.

You can also see a bovine bone here.

Atari arrives from the west.

>n
The trees are too thick to proceed in that direction.

>take bone
(the bovine bone)
As you reach for the bovine bone, Atari leaps in quickly and grabs it first.

>e
The trees are too thick to proceed in that direction.

Atari licks the surface of the bovine bone.

>se
The trees are too thick to proceed in that direction.

Atari gnaws at the bovine bone.

>s
Creepy Forest Path
You are on a north-south path through the woods. The trees in this area are twisted and creepy, and the canopy blocks all but a few slivers of light from above. 

Atari arrives from the north.

>s
Outside the Tower
You stand at the base of a large stone tower. The woods surround you in all directions, except for the lone path going to the north. 

Atari arrives from the north.

>n
Creepy Forest Path
You are on a north-south path through the woods. The trees in this area are twisted and creepy, and the canopy blocks all but a few slivers of light from above. 

Atari arrives from the south.

>e
The trees are too thick to proceed in that direction.

Atari happily chews on the bovine bone.

>w
The trees are too thick to proceed in that direction.

Atari licks the surface of the bovine bone.

>look
Creepy Forest Path
You are on a north-south path through the woods. The trees in this area are twisted and creepy, and the canopy blocks all but a few slivers of light from above. 

You can see Atari here.

Atari drops the bovine bone.

* * *

>take helmet
You can't see any such thing.

>e
You can't go that way.

>n
You can't go that way.

>w
You can't go that way.

* * *

>help
You can issue commands to the game by starting with a verb. For instance, typing EXAMINE THE DOOHICKEY will cause the game to report the results of such an examination. (You needn't type in uppercase, but I will use uppercase to distinguish the commands you may type in.) You may wish to try this now by typing EXAMINE SHELVES. 

Other useful commands are SEARCH (something), TAKE (an object), DROP (something you are carrying). Typing LOOK by itself will give you a description of the area you are currently in. A good strategy is to type LOOK to get the area description, and then use EXAMINE on the nouns that you see in the description. Many verbs have synonyms, for example you can type LOOK AT (something) instead of EXAMINE (something). Also, some commonly used verbs can be abbreviated, for examine EXAMINE SHELVES can be abbreviated with X SHELVES. 

You are not currently in a room with exits, but when you are you can move about with a command like GO SOUTH, SOUTH, or just S. Other directions can be abbreviated as well with a command like NW for northwest, etc.

Finally, you can type INVENTORY or just I to get a list of items that you are carrying. Also, if you want to repeat the last command, you can type AGAIN or just G. 

To get help on a specific topic, type HELP (topic). The following help topics are supported: 
    HELP introduction 
    HELP objects 
    HELP conversation 
    HELP saving

>enter mirror
You step through the mirror, and you feel a powerful force pulling you through. After being momentarily blinded, you find yourself in... 

Basement
You appear to be in some sort of Basement, lit solely by a lantern on a shelf. Shelves line the east and north walls, but they are mostly empty. A beautiful mirror stands against the south wall. A ladder pokes through the ceiling in the corner of the room.

On the shelves are journal page 2 and a brass lantern.

* * *

>take all
journal page 2: Taken.

brass lantern: Taken.

>w
You can't go that way.

>u
Inside the Shack
You are inside a dilapidated shack. There is a rather shabby door on the south side, which is closed. This appears to be someone's actual living quarters, as the furnishings are rather complete. It's only one room but there is a kitchen space for cooking as well as a creaky bed. A desk is in the corner, covered in stacks of paper. A ladder pokes through a hole in the floor.

On the kitchen counter is a piece of beef jerky.

>lay on bed
That's not a verb I recognise.

>examine bed
It's a twin-sized bed in rather poor condition, although the mattress does not look too uncomfortable.

>go on bed
You can't see any such thing.

>sit
You sits down.

>sit on bed
You get onto the creaky bed.

>have sex
That's not a verb I recognise.