HELP is available.

Life Boat
An Interactive Fiction by Anthony Maro, converted to I7 by Erik Ylvisaker
Release 1 / Serial number 180618 / Inform 7 build 6M62 (I6/v6.33 lib 6/12N) SD

Your cabin
You sit within your room, contemplating what to do next. The doorway is in the east wall, but the furnishings are too enticing to leave.

You hear explosions!

You can see a large bed here.

>push bed
You find a keycard.

You hear explosions!

>pull bed
Nothing obvious happens.

>take keycard
Taken.

>e
(first opening cabin door)
It seems to be locked.

>unlock door
(with the keycard)
You unlock cabin door.

>e
(first opening cabin door)

Hallway
You stand just outside your expensive cabin on the luxury liner. The hallway runs north-south with your cabin to the west. Sirens wail within the ship.

>n
Passageway
From here it is possible to go north, south, east, or west. To the south is the cargo bay, which is normally not pressurized.

>w
Hallway
You stand just outside your expensive cabin on the luxury liner. The hallway runs north-south with your cabin to the west. Sirens wail within the ship.

>e
You can't go that way.

You hear explosions!

>n
Passageway
From here it is possible to go north, south, east, or west. To the south is the cargo bay, which is normally not pressurized.

>n
Engine room
This is the master engine room. A shrill sound echoes from the northern crawlway. A rusted door exits to the south.

You can see a hatch in the floor here.

>n
Engines
Why did you do that? Was it not obvious that these are the engines? You have consequently incinerated yourself. Are you happy now?

Better luck next time.

    *** You have died ***

In that game you scored 0 out of a possible 0, in 12 turns.

Would you like to RESTART, RESTORE a saved game, QUIT or UNDO the last command?

* * *

>push bed
You find a keycard.

You hear explosions!

>unlock door
What do you want to unlock cabin door with?

>keycard
(first taking the keycard)
You unlock cabin door.

>e
(first opening cabin door)

Hallway
You stand just outside your expensive cabin on the luxury liner. The hallway runs north-south with your cabin to the west. Sirens wail within the ship.

>s
Passageway
One of the many passageways on the ship, from here it is possible to go north, south, east, and west.

>e
Lifeboat Bay
Two of the three lifeboats are missing; the last lifeboat is to the east. Two curving passageways exit from here, one north and one south.

>s
Passageway
One of the many passageways on the ship, from here it is possible to go north, south, east, and west.

>s
Computer room
Strewn about the floor of this computer room are broken memory crystals, apparently from the ship's main computer. A locked hatch is in the floor, and exits are north and south.

>type something
The screen replies:
Enter 1 to pressurize cargo.
Enter 2 to activate LifeBoat.

Enter your choice now -

>1
OK.

>s
Bridge
The bridge is in shambles! Someone has definitely sabotaged the ship. Are you getting worried yet? One exit leads north.

You can see a bent crowbar here.

>n
Computer room
Strewn about the floor of this computer room are broken memory crystals, apparently from the ship's main computer. A locked hatch is in the floor, and exits are north and south.

>n
Passageway
One of the many passageways on the ship, from here it is possible to go north, south, east, and west.

>n
Cargo
All of these crates contain cargo to be taken to your destination. A few might contain spare parts. Doors lead north and south.

You can see a large crate (closed) here.

>open crate
The crate is sealed pretty good.

>s
Passageway
One of the many passageways on the ship, from here it is possible to go north, south, east, and west.

You hear explosions!

>s
Computer room
Strewn about the floor of this computer room are broken memory crystals, apparently from the ship's main computer. A locked hatch is in the floor, and exits are north and south.

>s
Bridge
The bridge is in shambles! Someone has definitely sabotaged the ship. Are you getting worried yet? One exit leads north.

You can see a bent crowbar here.

>take crowbar
Taken.

>n
Computer room
Strewn about the floor of this computer room are broken memory crystals, apparently from the ship's main computer. A locked hatch is in the floor, and exits are north and south.

You hear explosions!

>n
Passageway
One of the many passageways on the ship, from here it is possible to go north, south, east, and west.

* * *

>n
Cargo
All of these crates contain cargo to be taken to your destination. A few might contain spare parts. Doors lead north and south.

You can see a large crate (closed) here.

>open crate
You find something!

In the large crate is a small device.

You hear explosions!

>i
You are carrying:
  a bent crowbar
  a keycard

>open crate with crowbar
That doesn't seem to be something you can unlock.

>s
Passageway
One of the many passageways on the ship, from here it is possible to go north, south, east, and west.

You hear explosions!

>e
Lifeboat Bay
Two of the three lifeboats are missing; the last lifeboat is to the east. Two curving passageways exit from here, one north and one south.

>w
You can't go that way.

>e
Lifeboat
The lifeboat is a little banged-up. Some parts seem to be missing. It is as if you are not wanted to leave!

>z
Time passes.

>i
You are carrying:
  a bent crowbar
  a keycard

>w
Lifeboat Bay
Two of the three lifeboats are missing; the last lifeboat is to the east. Two curving passageways exit from here, one north and one south.

>s
Passageway
One of the many passageways on the ship, from here it is possible to go north, south, east, and west.

* * *

>e
Lifeboat Bay
Two of the three lifeboats are missing; the last lifeboat is to the east. Two curving passageways exit from here, one north and one south.

>e
Lifeboat
The lifeboat is a little banged-up. Some parts seem to be missing. It is as if you are not wanted to leave!

>e
Lifeboat Bay
Two of the three lifeboats are missing; the last lifeboat is to the east. Two curving passageways exit from here, one north and one south.

>i
You are carrying:
  a bent crowbar
  a keycard

>w
You can't go that way.

>s
Passageway
One of the many passageways on the ship, from here it is possible to go north, south, east, and west.

>w
Hallway
You stand just outside your expensive cabin on the luxury liner. The hallway runs north-south with your cabin to the west. Sirens wail within the ship.

>w
Your cabin
You sit within your room, contemplating what to do next. The doorway is in the east wall, but the furnishings are too enticing to leave.

You can see a large bed here.

>look
Your cabin
You sit within your room, contemplating what to do next. The doorway is in the east wall, but the furnishings are too enticing to leave.

You can see a large bed here.

>e
Hallway
You stand just outside your expensive cabin on the luxury liner. The hallway runs north-south with your cabin to the west. Sirens wail within the ship.

You hear explosions!

>s
Passageway
One of the many passageways on the ship, from here it is possible to go north, south, east, and west.

* * *

>s
Computer room
Strewn about the floor of this computer room are broken memory crystals, apparently from the ship's main computer. A locked hatch is in the floor, and exits are north and south.

>s
Bridge
The bridge is in shambles! Someone has definitely sabotaged the ship. Are you getting worried yet? One exit leads north.

>n
Computer room
Strewn about the floor of this computer room are broken memory crystals, apparently from the ship's main computer. A locked hatch is in the floor, and exits are north and south.

>help
Type something here!

>type something
The screen replies:
Enter 1 to pressurize cargo.
Enter 2 to activate LifeBoat.

Enter your choice now -

>2
OK.
Non functional.

>i
You are carrying:
  a bent crowbar
  a keycard

>n
Passageway
One of the many passageways on the ship, from here it is possible to go north, south, east, and west.

>n
Cargo
All of these crates contain cargo to be taken to your destination. A few might contain spare parts. Doors lead north and south.

You can see a large crate (in which is a small device) here.

>take device
Taken.

>n
Passageway
From here it is possible to go north, south, east, or west. To the south is the cargo bay, which is normally not pressurized.

>e
Lifeboat Bay
Two of the three lifeboats are missing; the last lifeboat is to the east. Two curving passageways exit from here, one north and one south.

>e
Lifeboat
The lifeboat is a little banged-up. Some parts seem to be missing. It is as if you are not wanted to leave!

You hear explosions!
The small device apparently fits a hole in the instrument board.  With care you insert the device. The lifeboat hums with energy.

>i
You are carrying:
  a bent crowbar
  a keycard

You hear explosions!

>s
Lifeboat Bay
Two of the three lifeboats are missing; the last lifeboat is to the east. Two curving passageways exit from here, one north and one south.

>s
Passageway
One of the many passageways on the ship, from here it is possible to go north, south, east, and west.

* * *

>type something
The screen replies:
Enter 1 to pressurize cargo.
Enter 2 to activate LifeBoat.

Enter your choice now -

>2
OK.
4 moves to launch.

>n
Passageway
One of the many passageways on the ship, from here it is possible to go north, south, east, and west.

3 moves to launch.

>e
Lifeboat Bay
Two of the three lifeboats are missing; the last lifeboat is to the east. Two curving passageways exit from here, one north and one south.

2 moves to launch.

>e
Lifeboat
The lifeboat is a little banged-up. Some parts seem to be missing. It is as if you are not wanted to leave!

As you enter, the lifeboat seals and slowly lifts away from the ship. You have made good your escape.

    *** You have won ***

In that game you scored 0 out of a possible 0, in 62 turns.

Would you like to RESTART, RESTORE a saved game, QUIT or UNDO the last command?

>undo
Lifeboat Bay
[Previous turn undone.]

>w
You can't go that way.

1 moves to launch.

>w
You can't go that way.

0 moves to launch.

    *** The lifeboat has launched without you! ***

In that game you scored 0 out of a possible 0, in 63 turns.

Would you like to RESTART, RESTORE a saved game, QUIT or UNDO the last command?

* * *

HELP is available.

Life Boat
An Interactive Fiction by Anthony Maro, converted to I7 by Erik Ylvisaker
Release 1 / Serial number 180618 / Inform 7 build 6M62 (I6/v6.33 lib 6/12N) SD

Your cabin
You sit within your room, contemplating what to do next. The doorway is in the east wall, but the furnishings are too enticing to leave.

You hear explosions!

You can see a large bed here.

>move bed
You find a keycard.

>take keycard
Taken.

* * *

>e
(first opening cabin door)
It seems to be locked.

>unlock door
(with the keycard)
You unlock cabin door.

You hear explosions!

>e
(first opening cabin door)

Hallway
You stand just outside your expensive cabin on the luxury liner. The hallway runs north-south with your cabin to the west. Sirens wail within the ship.

* * *

>s
Computer room
Strewn about the floor of this computer room are broken memory crystals, apparently from the ship's main computer. A locked hatch is in the floor, and exits are north and south.

>open hatch
You can't see any such thing.

>s
Bridge
The bridge is in shambles! Someone has definitely sabotaged the ship. Are you getting worried yet? One exit leads north.

You can see a bent crowbar here.

* * *

>take crowbar
Taken.

>s
You can't go that way.

>n
Computer room
Strewn about the floor of this computer room are broken memory crystals, apparently from the ship's main computer. A locked hatch is in the floor, and exits are north and south.

>open hatch
You can't see any such thing.

>use crowbar
That's not a verb I recognise.

>pry\
That's not a verb I recognise.

>pry
That's not a verb I recognise.

>n
Passageway
One of the many passageways on the ship, from here it is possible to go north, south, east, and west.

>e
Lifeboat Bay
Two of the three lifeboats are missing; the last lifeboat is to the east. Two curving passageways exit from here, one north and one south.

You hear explosions!

>e
Lifeboat
The lifeboat is a little banged-up. Some parts seem to be missing. It is as if you are not wanted to leave!

>w
Lifeboat Bay
Two of the three lifeboats are missing; the last lifeboat is to the east. Two curving passageways exit from here, one north and one south.

* * *

>move bed
You find a keycard.

>take key
You can't see any such thing.

>take keycard
Taken.

You hear explosions!

>unlock door
(with the keycard)
You unlock cabin door.

* * *

>s
Bridge
The bridge is in shambles! Someone has definitely sabotaged the ship. Are you getting worried yet? One exit leads north.

You can see a bent crowbar here.

>take crowbar
Taken.

You hear explosions!

>n
Computer room
Strewn about the floor of this computer room are broken memory crystals, apparently from the ship's main computer. A locked hatch is in the floor, and exits are north and south.

>s
Bridge
The bridge is in shambles! Someone has definitely sabotaged the ship. Are you getting worried yet? One exit leads north.

>s
You can't go that way.

>n
Computer room
Strewn about the floor of this computer room are broken memory crystals, apparently from the ship's main computer. A locked hatch is in the floor, and exits are north and south.

You hear explosions!

* * *

>n
Passageway
One of the many passageways on the ship, from here it is possible to go north, south, east, and west.

>n
Cargo is not pressurized.

>e
Lifeboat Bay
Two of the three lifeboats are missing; the last lifeboat is to the east. Two curving passageways exit from here, one north and one south.

* * *

>w
Lifeboat Bay
Two of the three lifeboats are missing; the last lifeboat is to the east. Two curving passageways exit from here, one north and one south.

>n
Passageway
From here it is possible to go north, south, east, or west. To the south is the cargo bay, which is normally not pressurized.

* * *

>s
Passageway
One of the many passageways on the ship, from here it is possible to go north, south, east, and west.

>w
Hallway
You stand just outside your expensive cabin on the luxury liner. The hallway runs north-south with your cabin to the west. Sirens wail within the ship.

You hear explosions!

>n
Passageway
From here it is possible to go north, south, east, or west. To the south is the cargo bay, which is normally not pressurized.

* * *

>n
Engine room
This is the master engine room. A shrill sound echoes from the northern crawlway. A rusted door exits to the south.

You can see a hatch in the floor here.

>help
Type something.

>type
There is nothing to type on!

>s
Passageway
From here it is possible to go north, south, east, or west. To the south is the cargo bay, which is normally not pressurized.

>s
Cargo is not pressurized.

>s
Cargo is not pressurized.

>e
Lifeboat Bay
Two of the three lifeboats are missing; the last lifeboat is to the east. Two curving passageways exit from here, one north and one south.

* * *

>s
Computer room
Strewn about the floor of this computer room are broken memory crystals, apparently from the ship's main computer. A locked hatch is in the floor, and exits are north and south.

>type
The screen replies:
Enter 1 to pressurize cargo.
Enter 2 to activate LifeBoat.

You hear explosions!

Enter your choice now -

>1
OK.

>type
The screen replies:
Enter 1 to pressurize cargo.
Enter 2 to activate LifeBoat.

Enter your choice now -

>2
OK.
Non functional.

>n
Passageway
One of the many passageways on the ship, from here it is possible to go north, south, east, and west.

You hear explosions!

>w
Hallway
You stand just outside your expensive cabin on the luxury liner. The hallway runs north-south with your cabin to the west. Sirens wail within the ship.

>e
You can't go that way.

>n
Passageway
From here it is possible to go north, south, east, or west. To the south is the cargo bay, which is normally not pressurized.

* * *

>s
Bridge
The bridge is in shambles! Someone has definitely sabotaged the ship. Are you getting worried yet? One exit leads north.

>sn
That's not a verb I recognise.

>n
Computer room
Strewn about the floor of this computer room are broken memory crystals, apparently from the ship's main computer. A locked hatch is in the floor, and exits are north and south.

>w
You can't go that way.

>n
Passageway
One of the many passageways on the ship, from here it is possible to go north, south, east, and west.

>w
Hallway
You stand just outside your expensive cabin on the luxury liner. The hallway runs north-south with your cabin to the west. Sirens wail within the ship.

>n
Passageway
From here it is possible to go north, south, east, or west. To the south is the cargo bay, which is normally not pressurized.

>s
Cargo
All of these crates contain cargo to be taken to your destination. A few might contain spare parts. Doors lead north and south.

You can see a large crate (closed) here.

>open crate
You find something!

In the large crate is a small device.

>take device
Taken.

>e
You can't go that way.

>s
Passageway
One of the many passageways on the ship, from here it is possible to go north, south, east, and west.

You hear explosions!

* * *

>e
Lifeboat Bay
Two of the three lifeboats are missing; the last lifeboat is to the east. Two curving passageways exit from here, one north and one south.

>e
Lifeboat
The lifeboat is a little banged-up. Some parts seem to be missing. It is as if you are not wanted to leave!

The small device apparently fits a hole in the instrument board.  With care you insert the device. The lifeboat hums with energy.

>w
Lifeboat Bay
Two of the three lifeboats are missing; the last lifeboat is to the east. Two curving passageways exit from here, one north and one south.

* * *

>s
Computer room
Strewn about the floor of this computer room are broken memory crystals, apparently from the ship's main computer. A locked hatch is in the floor, and exits are north and south.

>type
The screen replies:
Enter 1 to pressurize cargo.
Enter 2 to activate LifeBoat.

Enter your choice now -

>2
OK.
4 moves to launch.

>n
Passageway
One of the many passageways on the ship, from here it is possible to go north, south, east, and west.

You hear explosions!
3 moves to launch.

>e
Lifeboat Bay
Two of the three lifeboats are missing; the last lifeboat is to the east. Two curving passageways exit from here, one north and one south.

2 moves to launch.

>e
Lifeboat
The lifeboat is a little banged-up. Some parts seem to be missing. It is as if you are not wanted to leave!

As you enter, the lifeboat seals and slowly lifts away from the ship. You have made good your escape.

    *** The End ***

Would you like to RESTART, RESTORE a saved game, QUIT or UNDO the last command?

>restart
HELP is available.

Life Boat
An Interactive Fiction by Anthony Maro, converted to I7 by Erik Ylvisaker
Release 1 / Serial number 180618 / Inform 7 build 6M62 (I6/v6.33 lib 6/12N) SD

Your cabin
You sit within your room, contemplating what to do next. The doorway is in the east wall, but the furnishings are too enticing to leave.

You hear explosions!

You can see a large bed here.

>move bed
You find a keycard.

* * *

>take keycard
Taken.

>unlock door
(with the keycard)
You unlock cabin door.

* * *

>take crowbar
Taken.

>n
Computer room
Strewn about the floor of this computer room are broken memory crystals, apparently from the ship's main computer. A locked hatch is in the floor, and exits are north and south.

>type
The screen replies:
Enter 1 to pressurize cargo.
Enter 2 to activate LifeBoat.

Enter your choice now -

>1
OK.

>n
Passageway
One of the many passageways on the ship, from here it is possible to go north, south, east, and west.

* * *

>w
Hallway
You stand just outside your expensive cabin on the luxury liner. The hallway runs north-south with your cabin to the west. Sirens wail within the ship.

>s
Passageway
One of the many passageways on the ship, from here it is possible to go north, south, east, and west.

* * *

>s
Computer room
Strewn about the floor of this computer room are broken memory crystals, apparently from the ship's main computer. A locked hatch is in the floor, and exits are north and south.

>n
Passageway
One of the many passageways on the ship, from here it is possible to go north, south, east, and west.

You hear explosions!

>n
Cargo
All of these crates contain cargo to be taken to your destination. A few might contain spare parts. Doors lead north and south.

You can see a large crate (closed) here.

You hear explosions!

>open crate
You find something!

In the large crate is a small device.

You hear explosions!

>take device
Taken.

* * *

>e
You can't go that way.

>s
Passageway
One of the many passageways on the ship, from here it is possible to go north, south, east, and west.

* * *

>e
Lifeboat Bay
Two of the three lifeboats are missing; the last lifeboat is to the east. Two curving passageways exit from here, one north and one south.

>E,
Lifeboat
The lifeboat is a little banged-up. Some parts seem to be missing. It is as if you are not wanted to leave!

The small device apparently fits a hole in the instrument board.  With care you insert the device. The lifeboat hums with energy.

>W
Lifeboat Bay
Two of the three lifeboats are missing; the last lifeboat is to the east. Two curving passageways exit from here, one north and one south.

>S
Passageway
One of the many passageways on the ship, from here it is possible to go north, south, east, and west.

>S
Computer room
Strewn about the floor of this computer room are broken memory crystals, apparently from the ship's main computer. A locked hatch is in the floor, and exits are north and south.

>TYPE
The screen replies:
Enter 1 to pressurize cargo.
Enter 2 to activate LifeBoat.

Enter your choice now -

>2
OK.
4 moves to launch.

* * *

>n
Passageway
One of the many passageways on the ship, from here it is possible to go north, south, east, and west.

You hear explosions!
3 moves to launch.

>E
Lifeboat Bay
Two of the three lifeboats are missing; the last lifeboat is to the east. Two curving passageways exit from here, one north and one south.

You hear explosions!
2 moves to launch.

>e
Lifeboat
The lifeboat is a little banged-up. Some parts seem to be missing. It is as if you are not wanted to leave!

As you enter, the lifeboat seals and slowly lifts away from the ship. You have made good your escape.

    *** The End ***

Would you like to RESTART, RESTORE a saved game, QUIT or UNDO the last command?