Castle of Spirits
An Interactive Fiction by Anthony Maro, converted to I7 by Erik Ylvisaker
Release 1 / Serial number 180526 / Inform 7 build 6M62 (I6/v6.33 lib 6/12N) SD

Courtyard
You are in a large courtyard with a dilapidated shed in the corner. The south edge is lined by an old stone wall with a portcullis in the middle.

Whilst going about your business a more than slightly deranged apparition appears. He seems to be screaming some nonsense about no escape. The ghost very impolitely laughs in your face, then vanishes to whatever unsightly place he appeared from.

Type HELP to get help.

>s
Something solid hits you in the face.

I beg your pardon?

* * *

>s
Something solid hits you in the face.

>w
W. Courtyard
This is the west courtyard. The stables are to the south, and a domineering tower stands silhouetted against the sky, the entrance of which is covered in vines.

>w
Something solid hits you in the face.

>n
Something solid hits you in the face.

>s
(first opening stable door)
It seems to be locked.

>e
Courtyard
You are in a large courtyard with a dilapidated shed in the corner. The south edge is lined by an old stone wall with a portcullis in the middle.

>n
By the Gates
There is a monstrous gate set in the north wall.  To the south is the courtyard and to the east is a small house.

>n
A ghostly knight in a full suit of armor refuses to let you pass.

>s
Courtyard
You are in a large courtyard with a dilapidated shed in the corner. The south edge is lined by an old stone wall with a portcullis in the middle.

>w
W. Courtyard
This is the west courtyard. The stables are to the south, and a domineering tower stands silhouetted against the sky, the entrance of which is covered in vines.

>s
(first opening stable door)
It seems to be locked.

* * *

>e
Courtyard
You are in a large courtyard with a dilapidated shed in the corner. The south edge is lined by an old stone wall with a portcullis in the middle.

>e
E. Courtyard
This is the east courtyard. A small gap exists in the south wall of the castle. A domineering tower stands silhouetted against the sky, the entrance of which is covered in vines.

>s
Gap in Wall
You stand in a small gap in the wall of which the only exit is north.

You can see an electromagnet here.

You quite suddenly are interrupted by an overpowering vampire. While struggling for your life he calmly drinks your blood. You have died.

    *** The End ***

Would you like to RESTART, RESTORE a saved game, QUIT or UNDO the last command?

>restart
Castle of Spirits
An Interactive Fiction by Anthony Maro, converted to I7 by Erik Ylvisaker
Release 1 / Serial number 150329 / Inform 7 build 6L38 (I6/v6.33 lib 6/12N) SD

Courtyard
You are in a large courtyard with a dilapidated shed in the corner. The south edge is lined by an old stone wall with a portcullis in the middle.

Whilst going about your business a more than slightly deranged apparition appears. He seems to be screaming some nonsense about no escape. The ghost very impolitely laughs in your face, then vanishes to whatever unsightly place he appeared from.

>e
E. Courtyard
This is the east courtyard. A small gap exists in the south wall of the castle. A domineering tower stands silhouetted against the sky, the entrance of which is covered in vines.

>s
Gap in Wall
You stand in a small gap in the wall of which the only exit is north.

You can see an electromagnet here.

>take electromagnet
Taken.

>n
E. Courtyard
This is the east courtyard. A small gap exists in the south wall of the castle. A domineering tower stands silhouetted against the sky, the entrance of which is covered in vines.

>w
Courtyard
You are in a large courtyard with a dilapidated shed in the corner. The south edge is lined by an old stone wall with a portcullis in the middle.

>s
Something solid hits you in the face.

* * *

>s
(first opening stable door)
It seems to be locked.

>enter tower
(first opening the tower door)
The door is stuck!

>e
Courtyard
You are in a large courtyard with a dilapidated shed in the corner. The south edge is lined by an old stone wall with a portcullis in the middle.

* * *

>e
E. Courtyard
This is the east courtyard. A small gap exists in the south wall of the castle. A domineering tower stands silhouetted against the sky, the entrance of which is covered in vines.

>enter tower
(first opening the tower door)
The door is stuck!

>s
Gap in Wall
You stand in a small gap in the wall of which the only exit is north.

>n
E. Courtyard
This is the east courtyard. A small gap exists in the south wall of the castle. A domineering tower stands silhouetted against the sky, the entrance of which is covered in vines.

You quite suddenly are interrupted by an overpowering vampire. While struggling for your life he calmly drinks your blood. You have died.

    *** The End ***

Would you like to RESTART, RESTORE a saved game, QUIT or UNDO the last command?

>restart
Castle of Spirits
An Interactive Fiction by Anthony Maro, converted to I7 by Erik Ylvisaker
Release 1 / Serial number 150329 / Inform 7 build 6L38 (I6/v6.33 lib 6/12N) SD

Courtyard
You are in a large courtyard with a dilapidated shed in the corner. The south edge is lined by an old stone wall with a portcullis in the middle.

Whilst going about your business a more than slightly deranged apparition appears. He seems to be screaming some nonsense about no escape. The ghost very impolitely laughs in your face, then vanishes to whatever unsightly place he appeared from.

>n
By the Gates
There is a monstrous gate set in the north wall.  To the south is the courtyard and to the east is a small house.

>e
Guard Quarters
This is a small guard's shack. Various everyday items are on the floor.

You can see a black box here.

>open box
It isn't something you can open.

>take box
Taken.

>look box
There are three buttons the color of a traffic light imbedded in the side.

>push green
CLICK.

>push yellow
The box opens and I now have a key.

>w
By the Gates
There is a monstrous gate set in the north wall.  To the south is the courtyard and to the east is a small house.

>s
Courtyard
You are in a large courtyard with a dilapidated shed in the corner. The south edge is lined by an old stone wall with a portcullis in the middle.

* * *

>w
W. Courtyard
This is the west courtyard. The stables are to the south, and a domineering tower stands silhouetted against the sky, the entrance of which is covered in vines.

>unlock door
Which do you mean, the tower door or stable door?

>s
I didn't understand that sentence.

>unlock door
Which do you mean, the tower door or stable door?

>stable
What do you want to unlock stable door with?

>key
You unlock stable door.

>s
(first opening stable door)

Stables
You stand in the stables, which have apparently not been kept very clean.

You can see a garlic bloom here.

>take garlic
Taken.

>n
W. Courtyard
This is the west courtyard. The stables are to the south, and a domineering tower stands silhouetted against the sky, the entrance of which is covered in vines.

You quite suddenly are interrupted by an overpowering vampire. He takes one sniff of your garlic, sticks up his nose and then flies away.

>e
Courtyard
You are in a large courtyard with a dilapidated shed in the corner. The south edge is lined by an old stone wall with a portcullis in the middle.

* * *

>s
Gap in Wall
You stand in a small gap in the wall of which the only exit is north.

You can see an electromagnet here.

>take magnet
Taken.

>n
E. Courtyard
This is the east courtyard. A small gap exists in the south wall of the castle. A domineering tower stands silhouetted against the sky, the entrance of which is covered in vines.

>enter tower
(first opening the tower door)
The door is stuck!

>unlock tower
What do you want to unlock the tower door with?

>key
That doesn't seem to be something you can unlock.

>i
You are carrying:
  an electromagnet
  a garlic bloom
  a key
  a black box

>w
Courtyard
You are in a large courtyard with a dilapidated shed in the corner. The south edge is lined by an old stone wall with a portcullis in the middle.

* * *

>s
Something solid hits you in the face.

>n
By the Gates
There is a monstrous gate set in the north wall.  To the south is the courtyard and to the east is a small house.

* * *

>n
A ghostly knight in a full suit of armor refuses to let you pass.

>e
Guard Quarters
This is a small guard's shack. Various everyday items are on the floor.

>w
By the Gates
There is a monstrous gate set in the north wall.  To the south is the courtyard and to the east is a small house.

* * *

>w
W. Courtyard
This is the west courtyard. The stables are to the south, and a domineering tower stands silhouetted against the sky, the entrance of which is covered in vines.

>enter tower
(first opening the tower door)
The door is stuck!

>s
Stables
You stand in the stables, which have apparently not been kept very clean.

>s
Something solid hits you in the face.

>w
Something solid hits you in the face.

>s
Something solid hits you in the face.

>n
W. Courtyard
This is the west courtyard. The stables are to the south, and a domineering tower stands silhouetted against the sky, the entrance of which is covered in vines.

>w
Something solid hits you in the face.

>e
Courtyard
You are in a large courtyard with a dilapidated shed in the corner. The south edge is lined by an old stone wall with a portcullis in the middle.

* * *

>e
E. Courtyard
This is the east courtyard. A small gap exists in the south wall of the castle. A domineering tower stands silhouetted against the sky, the entrance of which is covered in vines.

>s
Gap in Wall
You stand in a small gap in the wall of which the only exit is north.

>n
E. Courtyard
This is the east courtyard. A small gap exists in the south wall of the castle. A domineering tower stands silhouetted against the sky, the entrance of which is covered in vines.

* * *

>w
Courtyard
You are in a large courtyard with a dilapidated shed in the corner. The south edge is lined by an old stone wall with a portcullis in the middle.

>w
W. Courtyard
This is the west courtyard. The stables are to the south, and a domineering tower stands silhouetted against the sky, the entrance of which is covered in vines.

>enter shed
You can't see any such thing.

>e
Courtyard
You are in a large courtyard with a dilapidated shed in the corner. The south edge is lined by an old stone wall with a portcullis in the middle.

* * *

>e
E. Courtyard
This is the east courtyard. A small gap exists in the south wall of the castle. A domineering tower stands silhouetted against the sky, the entrance of which is covered in vines.

>enter shed
You can't see any such thing.

>w
Courtyard
You are in a large courtyard with a dilapidated shed in the corner. The south edge is lined by an old stone wall with a portcullis in the middle.

* * *

>s
Something solid hits you in the face.

>look shed
You see nothing special about the shed.

>enter shed
Tool shed
There are various tools and other items of no or some interest in the tool shed. The entrance is north.

You can see an oil can and an old shovel here.

>take oil
Taken.

>n
Courtyard
You are in a large courtyard with a dilapidated shed in the corner. The south edge is lined by an old stone wall with a portcullis in the middle.

>w
W. Courtyard
This is the west courtyard. The stables are to the south, and a domineering tower stands silhouetted against the sky, the entrance of which is covered in vines.

>oil door
(the tower door)
OK.

>enter tower
(first opening the tower door)

Tower
This is the bottom floor of one of the many towers in this castle. An exit is south of here.

You can see a car battery here.

>take battery
Taken.

>u
Tower
The endless floors all appear the same in this tower. Up or down?

>u
Tower
The endless floors all appear the same in this tower. Up or down?

>s
Something solid hits you in the face.

>d
Tower
This is the bottom floor of one of the many towers in this castle. An exit is south of here.

>s
W. Courtyard
This is the west courtyard. The stables are to the south, and a domineering tower stands silhouetted against the sky, the entrance of which is covered in vines.

>e
Courtyard
You are in a large courtyard with a dilapidated shed in the corner. The south edge is lined by an old stone wall with a portcullis in the middle.

* * *

Castle of Spirits
An Interactive Fiction by Anthony Maro, converted to I7 by Erik Ylvisaker
Release 1 / Serial number 180526 / Inform 7 build 6M62 (I6/v6.33 lib 6/12N) SD

Courtyard
You are in a large courtyard with a dilapidated shed in the corner. The south edge is lined by an old stone wall with a portcullis in the middle.

Whilst going about your business a more than slightly deranged apparition appears. He seems to be screaming some nonsense about no escape. The ghost very impolitely laughs in your face, then vanishes to whatever unsightly place he appeared from.

Type HELP to get help.

>look
Courtyard
You are in a large courtyard with a dilapidated shed in the corner. The south edge is lined by an old stone wall with a portcullis in the middle.

>s
Something solid hits you in the face.

>e
E. Courtyard
This is the east courtyard. A small gap exists in the south wall of the castle. A domineering tower stands silhouetted against the sky, the entrance of which is covered in vines.

>e
Something solid hits you in the face.

>s
Gap in Wall
You stand in a small gap in the wall of which the only exit is north.

You can see an electromagnet here.

>take
(the electromagnet)
Taken.

>s
Something solid hits you in the face.

>n
E. Courtyard
This is the east courtyard. A small gap exists in the south wall of the castle. A domineering tower stands silhouetted against the sky, the entrance of which is covered in vines.

>e
Something solid hits you in the face.

>w
Courtyard
You are in a large courtyard with a dilapidated shed in the corner. The south edge is lined by an old stone wall with a portcullis in the middle.

* * *

>e
Courtyard
You are in a large courtyard with a dilapidated shed in the corner. The south edge is lined by an old stone wall with a portcullis in the middle.

>s
Something solid hits you in the face.

>restart
Are you sure you want to restart?

>s
Please answer yes or no.

>w
Please answer yes or no.

* * *

>w
W. Courtyard
This is the west courtyard. The stables are to the south, and a domineering tower stands silhouetted against the sky, the entrance of which is covered in vines.

>open
(the electromagnet)
It isn't something you can open.

>enter tower
(first opening the tower door)
The door is stuck!

* * *

>e
E. Courtyard
This is the east courtyard. A small gap exists in the south wall of the castle. A domineering tower stands silhouetted against the sky, the entrance of which is covered in vines.

>open tower
The door is stuck!

>s
Gap in Wall
You stand in a small gap in the wall of which the only exit is north.

>take magnet
You already have that.

>n
E. Courtyard
This is the east courtyard. A small gap exists in the south wall of the castle. A domineering tower stands silhouetted against the sky, the entrance of which is covered in vines.

* * *

>w
Courtyard
You are in a large courtyard with a dilapidated shed in the corner. The south edge is lined by an old stone wall with a portcullis in the middle.

>n
By the Gates
There is a monstrous gate set in the north wall.  To the south is the courtyard and to the east is a small house.

* * *

>e
Guard Quarters
This is a small guard's shack. Various everyday items are on the floor.

You can see a black box here.

>restart
Are you sure you want to restart?

>y
Castle of Spirits
An Interactive Fiction by Anthony Maro, converted to I7 by Erik Ylvisaker
Release 1 / Serial number 180526 / Inform 7 build 6M62 (I6/v6.33 lib 6/12N) SD

Courtyard
You are in a large courtyard with a dilapidated shed in the corner. The south edge is lined by an old stone wall with a portcullis in the middle.

Whilst going about your business a more than slightly deranged apparition appears. He seems to be screaming some nonsense about no escape. The ghost very impolitely laughs in your face, then vanishes to whatever unsightly place he appeared from.

* * *

Castle of Spirits
An Interactive Fiction by Anthony Maro, converted to I7 by Erik Ylvisaker
Release 1 / Serial number 180526 / Inform 7 build 6M62 (I6/v6.33 lib 6/12N) SD

Courtyard
You are in a large courtyard with a dilapidated shed in the corner. The south edge is lined by an old stone wall with a portcullis in the middle.

Whilst going about your business a more than slightly deranged apparition appears. He seems to be screaming some nonsense about no escape. The ghost very impolitely laughs in your face, then vanishes to whatever unsightly place he appeared from.

Type HELP to get help.

>n
By the Gates
There is a monstrous gate set in the north wall.  To the south is the courtyard and to the east is a small house.

* * *

>e
Guard Quarters
This is a small guard's shack. Various everyday items are on the floor.

You can see a black box here.

>take box
Taken.

* * *

>push yellow
The box opens and I now have a key.

>push red
Boom!!!!
You made a mistake!

    *** The End ***

Would you like to RESTART, RESTORE a saved game, QUIT or UNDO the last command?

>restart
Castle of Spirits
An Interactive Fiction by Anthony Maro, converted to I7 by Erik Ylvisaker
Release 1 / Serial number 180526 / Inform 7 build 6M62 (I6/v6.33 lib 6/12N) SD

Courtyard
You are in a large courtyard with a dilapidated shed in the corner. The south edge is lined by an old stone wall with a portcullis in the middle.

Whilst going about your business a more than slightly deranged apparition appears. He seems to be screaming some nonsense about no escape. The ghost very impolitely laughs in your face, then vanishes to whatever unsightly place he appeared from.

>n
By the Gates
There is a monstrous gate set in the north wall.  To the south is the courtyard and to the east is a small house.

* * *

>take box
Taken.

>push green
CLICK.

* * *

>s
(first opening stable door)
It seems to be locked.

>open door
Which do you mean, the tower door or stable door?

>stable door
It seems to be locked.

>unlock stable door
What do you want to unlock stable door with?

>unlock stable door with key
You unlock stable door.

* * *

>take box
Taken.

>w
By the Gates
There is a monstrous gate set in the north wall.  To the south is the courtyard and to the east is a small house.

* * *

>w
W. Courtyard
This is the west courtyard. The stables are to the south, and a domineering tower stands silhouetted against the sky, the entrance of which is covered in vines.

>push green
CLICK.

* * *

>push yellow
The box opens and I now have a key.

>unlock stable door with key
You unlock stable door.

>s
(first opening stable door)

Stables
You stand in the stables, which have apparently not been kept very clean.

You can see a garlic bloom here.

>take garlic
Taken.

Gee, it's getting late. Almost midnight. Sure hope nothing bad happens.

>z
Time passes.

>z
Time passes.

I beg your pardon?

I beg your pardon?

>z
Time passes.

>n
W. Courtyard
This is the west courtyard. The stables are to the south, and a domineering tower stands silhouetted against the sky, the entrance of which is covered in vines.

You quite suddenly are interrupted by an overpowering vampire. He takes one sniff of your garlic, sticks up his nose and then flies away.

* * *

>s
Gap in Wall
You stand in a small gap in the wall of which the only exit is north.

You can see an electromagnet here.

>take ele
You can't see any such thing.

>take magnet
Taken.

* * *

>e
Something solid hits you in the face.

>open door
The door is stuck!

>w
Courtyard
You are in a large courtyard with a dilapidated shed in the corner. The south edge is lined by an old stone wall with a portcullis in the middle.

* * *

>w
W. Courtyard
This is the west courtyard. The stables are to the south, and a domineering tower stands silhouetted against the sky, the entrance of which is covered in vines.

>open door
Which do you mean, stable door or the tower door?

>tower
The door is stuck!

>w
Something solid hits you in the face.

* * *

>n
Something solid hits you in the face.

>e
Courtyard
You are in a large courtyard with a dilapidated shed in the corner. The south edge is lined by an old stone wall with a portcullis in the middle.

* * *

>n
A ghostly knight in a full suit of armor refuses to let you pass.

>n
A ghostly knight in a full suit of armor refuses to let you pass.

* * *

>s
Courtyard
You are in a large courtyard with a dilapidated shed in the corner. The south edge is lined by an old stone wall with a portcullis in the middle.

>e
E. Courtyard
This is the east courtyard. A small gap exists in the south wall of the castle. A domineering tower stands silhouetted against the sky, the entrance of which is covered in vines.

* * *

>w
W. Courtyard
This is the west courtyard. The stables are to the south, and a domineering tower stands silhouetted against the sky, the entrance of which is covered in vines.

>s
Stables
You stand in the stables, which have apparently not been kept very clean.

* * *

>s
Something solid hits you in the face.

>s
Something solid hits you in the face.

* * *

>n
W. Courtyard
This is the west courtyard. The stables are to the south, and a domineering tower stands silhouetted against the sky, the entrance of which is covered in vines.

>e
Courtyard
You are in a large courtyard with a dilapidated shed in the corner. The south edge is lined by an old stone wall with a portcullis in the middle.

* * *

>s
Gap in Wall
You stand in a small gap in the wall of which the only exit is north.

>s
Something solid hits you in the face.

>e
Something solid hits you in the face.

>n
E. Courtyard
This is the east courtyard. A small gap exists in the south wall of the castle. A domineering tower stands silhouetted against the sky, the entrance of which is covered in vines.

>ne
Something solid hits you in the face.

>e
Something solid hits you in the face.

>n
Something solid hits you in the face.

>enter tower
(first opening the tower door)
The door is stuck!

>w
Courtyard
You are in a large courtyard with a dilapidated shed in the corner. The south edge is lined by an old stone wall with a portcullis in the middle.

* * *

>enter tower
(first opening the tower door)
The door is stuck!

>i
You are carrying:
  an electromagnet
  a garlic bloom
  a key
  a black box

>e
Courtyard
You are in a large courtyard with a dilapidated shed in the corner. The south edge is lined by an old stone wall with a portcullis in the middle.

>enter shed
Tool shed
There are various tools and other items of no or some interest in the tool shed. The entrance is north.

You can see an oil can and an old shovel here.

>take all
oil can: Taken.
old shovel: Taken.

>n
Courtyard
You are in a large courtyard with a dilapidated shed in the corner. The south edge is lined by an old stone wall with a portcullis in the middle.

>e
E. Courtyard
This is the east courtyard. A small gap exists in the south wall of the castle. A domineering tower stands silhouetted against the sky, the entrance of which is covered in vines.

>oil door
OK.

>e
Something solid hits you in the face.

* * *

>n
Something solid hits you in the face.

>enter tower
(first opening the tower door)

Tower
This is the bottom floor of one of the many towers in this castle. An exit is south of here.

>u
Tower
The endless floors all appear the same in this tower. Up or down?

>d
Tower
This is the bottom floor of one of the many towers in this castle. An exit is south of here.

>d
Something solid hits you in the face.

>u
Tower
The endless floors all appear the same in this tower. Up or down?

* * *

>d
Tower
This is the bottom floor of one of the many towers in this castle. An exit is south of here.

>s
E. Courtyard
This is the east courtyard. A small gap exists in the south wall of the castle. A domineering tower stands silhouetted against the sky, the entrance of which is covered in vines.

>i
You are carrying:
  an old shovel
  an oil can
  an electromagnet
  a garlic bloom
  a key
  a black box

>w
Courtyard
You are in a large courtyard with a dilapidated shed in the corner. The south edge is lined by an old stone wall with a portcullis in the middle.

* * *

>enter tower
(first opening the tower door)
The door is stuck!

>oil door
(the tower door)
OK.

* * *

>take battery
Taken.

>e
Something solid hits you in the face.

>s
W. Courtyard
This is the west courtyard. The stables are to the south, and a domineering tower stands silhouetted against the sky, the entrance of which is covered in vines.

* * *

>n
By the Gates
There is a monstrous gate set in the north wall.  To the south is the courtyard and to the east is a small house.

>n
The ghostly guard is apparently scared of the magnet and refuses to come near you. You very casually stroll out of the castle. CONGRATULATIONS from Anthony Maro, programmer.

    *** The End ***

Would you like to RESTART, RESTORE a saved game, QUIT or UNDO the last command?

* * *

>n
A ghostly knight in a full suit of armor refuses to let you pass.

>look ghost
The ghostly knight is wearing a full suit of decidedly un-ghostly armor.

>talk to ghost
That's not a verb I recognise.

>speak to ghost
I didn't understand that sentence.

* * *

Castle of Spirits
An Interactive Fiction by Anthony Maro, converted to I7 by Erik Ylvisaker
Release 1 / Serial number 180526 / Inform 7 build 6M62 (I6/v6.33 lib 6/12N) SD

Courtyard
You are in a large courtyard with a dilapidated shed in the corner. The south edge is lined by an old stone wall with a portcullis in the middle.

Whilst going about your business a more than slightly deranged apparition appears. He seems to be screaming some nonsense about no escape. The ghost very impolitely laughs in your face, then vanishes to whatever unsightly place he appeared from.

Type HELP to get help.

>help
Move by typing "Go North", "Go N", or just "N". You can also use South, East or West. Enter can be used to enter some buildings. Look At can be used to examine your surroundings or objects. Try an explore to see if you can find a way out of the castle.

>[enter]
This is a simple demonstration Fiction game.

Please press SPACE to continue.

> Introduction to Castle of Spirits
   Instructions for Play
   Useful Commands
   Hints
   Settings

 > Introduction to Castle of Spirits
   Instructions for Play
   Useful Commands
   Hints
   Settings

>[down]
Introduction to Castle of Spirits
 > Instructions for Play
   Useful Commands
   Hints
   Settings

   Introduction to Castle of Spirits
 > Instructions for Play
   Useful Commands
   Hints
   Settings

>[enter]
> About Interactive Fiction
   What to do with >
   Getting Started
   Rooms and Travel
   Objects
   Controlling the Game
   How the World is Assembled
   If You Get Stuck

>[down]
About Interactive Fiction
 > What to do with >
   Getting Started
   Rooms and Travel
   Objects
   Controlling the Game
   How the World is Assembled
   If You Get Stuck

   About Interactive Fiction
 > What to do with >
   Getting Started
   Rooms and Travel
   Objects
   Controlling the Game
   How the World is Assembled
   If You Get Stuck

>[enter]
The > sign is where the game says, "Okay, what do you want to do now?"  You may respond by typing an instruction -- usually an imperative verb, possibly followed by prepositions and objects.  So, for instance, LOOK, LOOK AT FISH, TAKE FISH.

Please press SPACE to continue.

* * *

About Interactive Fiction
 > What to do with >
   Getting Started
   Rooms and Travel
   Objects
   Controlling the Game
   How the World is Assembled
   If You Get Stuck

   About Interactive Fiction
 > What to do with >
   Getting Started
   Rooms and Travel
   Objects
   Controlling the Game
   How the World is Assembled
   If You Get Stuck

>[right]
About Interactive Fiction
 > What to do with >
   Getting Started
   Rooms and Travel
   Objects
   Controlling the Game
   How the World is Assembled
   If You Get Stuck

>[right]
About Interactive Fiction
 > What to do with >
   Getting Started
   Rooms and Travel
   Objects
   Controlling the Game
   How the World is Assembled
   If You Get Stuck

>p
> About Interactive Fiction
   What to do with >
   Getting Started
   Rooms and Travel
   Objects
   Controlling the Game
   How the World is Assembled
   If You Get Stuck

 > About Interactive Fiction
   What to do with >
   Getting Started
   Rooms and Travel
   Objects
   Controlling the Game
   How the World is Assembled
   If You Get Stuck

>[enter]
The game you are playing is a work of Interactive Fiction.  In interactive fiction you play the main character of a story.  You type commands which determine the actions of the character and the flow of the plot.  Some IF games include graphics, but most do not: the imagery is provided courtesy of your imagination.  On the other hand, there's a wide range of action available: whereas in other games you may be restricted to shooting, movement, or searching items you can click on with a mouse, IF allows you a wide range of verbs.

Please press SPACE to continue.

* * *

> About Interactive Fiction
   What to do with >
   Getting Started
   Rooms and Travel
   Objects
   Controlling the Game
   How the World is Assembled
   If You Get Stuck

 > About Interactive Fiction
   What to do with >
   Getting Started
   Rooms and Travel
   Objects
   Controlling the Game
   How the World is Assembled
   If You Get Stuck

* * *

>help
Move by typing "Go North", "Go N", or just "N". You can also use South, East or West. Enter can be used to enter some buildings. Look At can be used to examine your surroundings or objects. Try an explore to see if you can find a way out of the castle.

>n
By the Gates
There is a monstrous gate set in the north wall.  To the south is the courtyard and to the east is a small house.

>help
Use N, S, E, W to move around. You can also use Enter and Exit to enter some rooms. Try an explore your surroundings to see if you can find a way out.

>e
Guard Quarters
This is a small guard's shack. Various everyday items are on the floor.

You can see a black box here.

* * *

>take box
Taken.

>help
The sure was an odd box. You might want to look at it more closely.

>look at box
There are three buttons the color of a traffic light imbedded in the side.

>push green
CLICK.

* * *

>push yellow
The box opens and I now have a key.

>help
Wasn't there a locked door around here somewhere?

>w
By the Gates
There is a monstrous gate set in the north wall.  To the south is the courtyard and to the east is a small house.

Gee, it's getting late. Almost midnight. I sure hope nothing bad happens.

>s
Courtyard
You are in a large courtyard with a dilapidated shed in the corner. The south edge is lined by an old stone wall with a portcullis in the middle.

* * *

>s
(first opening stable door)
It seems to be locked.

>unlock door
Which do you mean, the tower door or stable door?

>tower
What do you want to unlock the tower door with?

>key
That doesn't seem to be something you can unlock.

>unlock stable door
What do you want to unlock stable door with?

>key
You unlock stable door.

* * *

>take garlic
Taken.

>n
W. Courtyard
This is the west courtyard. The stables are to the south, and a domineering tower stands silhouetted against the sky, the entrance of which is covered in vines.

>help
There must be something around here you can use to escape.

>e
Courtyard
You are in a large courtyard with a dilapidated shed in the corner. The south edge is lined by an old stone wall with a portcullis in the middle.

* * *

>take magnet
Taken.

>help
There must be some way to power up that electromagnet.

>n
E. Courtyard
This is the east courtyard. A small gap exists in the south wall of the castle. A domineering tower stands silhouetted against the sky, the entrance of which is covered in vines.

You quite suddenly are interrupted by an overpowering vampire. He takes one sniff of your garlic, sticks up his nose and then flies away.

>w
Courtyard
You are in a large courtyard with a dilapidated shed in the corner. The south edge is lined by an old stone wall with a portcullis in the middle.

* * *

>w
W. Courtyard
This is the west courtyard. The stables are to the south, and a domineering tower stands silhouetted against the sky, the entrance of which is covered in vines.

>oil door
(the tower door)
You don't have any oil!

>e
Courtyard
You are in a large courtyard with a dilapidated shed in the corner. The south edge is lined by an old stone wall with a portcullis in the middle.

* * *

>s
Something solid hits you in the face.

>enter
You must supply a noun.

>enter shed
Tool shed
There are various tools and other items of no or some interest in the tool shed. The entrance is north.

You can see an oil can and an old shovel here.

>take can
Taken.

>n
Courtyard
You are in a large courtyard with a dilapidated shed in the corner. The south edge is lined by an old stone wall with a portcullis in the middle.

* * *

>oil door
(the tower door)
OK.

>open door
Which do you mean, stable door or the tower door?

>tower
You open the tower door.

>enter tower
Tower
This is the bottom floor of one of the many towers in this castle. An exit is south of here.

You can see a car battery here.

>take battery
Taken.

>exit
But you aren't in anything at the moment.

>e
Something solid hits you in the face.

* * *

>n
By the Gates
There is a monstrous gate set in the north wall.  To the south is the courtyard and to the east is a small house.

>help
There's not much more I can help with! Try looking for an exit.

>n
The ghostly guard is apparently scared of the magnet and refuses to come near you. You very casually stroll out of the castle. CONGRATULATIONS from Anthony Maro, original programmer, and Erik Ylvisaker, inform port programmer.

    *** The End ***

Would you like to RESTART, RESTORE a saved game, QUIT or UNDO the last command?

* * *

>n
By the Gates
There is a monstrous gate set in the north wall.  To the south is the courtyard and to the east is a small house.

>enter gate
A ghostly knight in a full suit of armor refuses to let you pass.

>take knight
That's hardly portable.

>look at knight
The ghostly knight is wearing a full suit of decidedly un-ghostly armor.

>e
Guard Quarters
This is a small guard's shack. Various everyday items are on the floor.

You can see a black box here.

* * *

>w
W. Courtyard
This is the west courtyard. The stables are to the south, and a domineering tower stands silhouetted against the sky, the entrance of which is covered in vines.

>push green, yellow
You can't use multiple objects with that verb.

>push green
CLICK.

Gee, it's getting late. Almost midnight. I sure hope nothing bad happens.

>push yellow
The box opens and I now have a key.

>s
(first opening the stable door)
It seems to be locked.

>unlock door
Which do you mean, the tower door or the stable door?

>stable
What do you want to unlock the stable door with?

>key
You unlock the stable door.

>s
(first opening the stable door)

Stables
You stand in the stables, which have apparently not been kept very clean.

You can see a garlic bloom here.

>take garlic
Taken.

>help
There must be something around here you can use to escape.

>n
W. Courtyard
This is the west courtyard. The stables are to the south, and a domineering tower stands silhouetted against the sky, the entrance of which is covered in vines.

* * *

>n
E. Courtyard
This is the east courtyard. A small gap exists in the south wall of the castle. A domineering tower stands silhouetted against the sky, the entrance of which is covered in vines.

>enter gap
Gap in Wall
You stand in a small gap in the wall of which the only exit is north.

>help
If you just had a source of power, that electromagnet you're lugging around might just come in handy. Wasn't there a stuck door around here? I wonder if you can get it unstuck.

>w
Something solid hits you in the face.

You quite suddenly are interrupted by an overpowering vampire. He takes one sniff of your garlic, sticks up his nose and then flies away.

>i
You are carrying:
  an electromagnet
  a garlic bloom
  a key
  a black box

>help
If you just had a source of power, that electromagnet you're lugging around might just come in handy. Wasn't there a stuck door around here? I wonder if you can get it unstuck.

>n
E. Courtyard
This is the east courtyard. A small gap exists in the south wall of the castle. A domineering tower stands silhouetted against the sky, the entrance of which is covered in vines.

>help
That door looks like it could use some oil.

>oil door
You don't have any oil!

>e
Something solid hits you in the face.

>s
Gap in Wall
You stand in a small gap in the wall of which the only exit is north.

>w
Something solid hits you in the face.

>n
E. Courtyard
This is the east courtyard. A small gap exists in the south wall of the castle. A domineering tower stands silhouetted against the sky, the entrance of which is covered in vines.

* * *

>s
Something solid hits you in the face.

>enter shed
Tool shed
There are various tools and other items of no or some interest in the tool shed. The entrance is north.

You can see an oil can and an old shovel here.

* * *

>w
W. Courtyard
This is the west courtyard. The stables are to the south, and a domineering tower stands silhouetted against the sky, the entrance of which is covered in vines.

>help
Hmm.. that door is stuck. Maybe there's a way to lubricate it?

>e
Courtyard
You are in a large courtyard with a dilapidated shed in the corner. The south edge is lined by an old stone wall with a portcullis in the middle.

* * *

>e
E. Courtyard
This is the east courtyard. A small gap exists in the south wall of the castle. A domineering tower stands silhouetted against the sky, the entrance of which is covered in vines.

>help
Hmm.. that door is stuck. Maybe there's a way to lubricate it?

>s
Gap in Wall
You stand in a small gap in the wall of which the only exit is north.

>help
If you just had a source of power, that electromagnet you're lugging around might just come in handy. Wasn't there a stuck door around here? I wonder if you can get it unstuck.

* * *

>n
E. Courtyard
This is the east courtyard. A small gap exists in the south wall of the castle. A domineering tower stands silhouetted against the sky, the entrance of which is covered in vines.

>oil door
OK.

>help
Wait, I thought there was another stuck door at the other tower.

>w
Courtyard
You are in a large courtyard with a dilapidated shed in the corner. The south edge is lined by an old stone wall with a portcullis in the middle.

* * *

>n
By the Gates
There is a monstrous gate set in the north wall.  To the south is the courtyard and to the east is a small house.

>n
The ghostly guard is apparently scared of the magnet and refuses to come near you. You very casually stroll out of the castle. CONGRATULATIONS from Anthony Maro, original programmer, and Erik Ylvisaker, inform port programmer.

    *** The End ***

Would you like to RESTART, RESTORE a saved game, QUIT or UNDO the last command?

* * *

Castle of Spirits
An Interactive Fiction by Anthony Maro, converted to I7 by Erik Ylvisaker
Release 1 / Serial number 180526 / Inform 7 build 6M62 (I6/v6.33 lib 6/12N) SD

Courtyard
You are in a large courtyard with a dilapidated shed in the corner. The south edge is lined by an old stone wall with a portcullis in the middle.

Whilst going about your business a more than slightly deranged apparition appears. He seems to be screaming some nonsense about no escape. The ghost very impolitely laughs in your face, then vanishes to whatever unsightly place he appeared from.

Type HELP to get help.

>enter castle
You're already in the castle. It's spooky here, and you should be trying to find your way out.

>enter portcullis
The portcullis is very solidly closed. It would take an act of god to move it.

>w'
That's not a verb I recognise.

>s
Something solid hits you in the face.

* * *

>w
W. Courtyard
This is the west courtyard. The stables are to the south, and a domineering tower stands silhouetted against the sky, the entrance of which is covered in vines.

>enter stables
You can't see any such thing.

>enter stables
You can't see any such thing.

* * *

Castle of Spirits
An Interactive Fiction by Anthony Maro, converted to I7 by Erik Ylvisaker
Release 1 / Serial number 180526 / Inform 7 build 6M62 (I6/v6.33 lib 6/12N) SD

Courtyard
You are in a large courtyard with a dilapidated shed in the corner. The south edge is lined by an old stone wall with a portcullis in the middle.

Whilst going about your business a more than slightly deranged apparition appears. He seems to be screaming some nonsense about no escape. The ghost very impolitely laughs in your face, then vanishes to whatever unsightly place he appeared from.

Type HELP to get help.

>w
W. Courtyard
This is the west courtyard. The stables are to the south, and a domineering tower stands silhouetted against the sky, the entrance of which is covered in vines.

>enter stable
(first opening stable door)
It seems to be locked.

>e
Courtyard
You are in a large courtyard with a dilapidated shed in the corner. The south edge is lined by an old stone wall with a portcullis in the middle.

* * *

>e
E. Courtyard
This is the east courtyard. A small gap exists in the south wall of the castle. A domineering tower stands silhouetted against the sky, the entrance of which is covered in vines.

>enter gap
You can't see any such thing.